GISJOIN,STATE,COUNTY,2010,1990,diff
G2200710,Louisiana,Orleans Parish,189896,225573,-35677
G2905100,Missouri,St. Louis city,176002,194919,-18917
G2601630,Michigan,Wayne County,821693,832710,-11017
G2200870,Louisiana,St. Bernard Parish,16794,25147,-8353
G2405100,Maryland,Baltimore City,296685,303706,-7021
G4201010,Pennsylvania,Philadelphia County,670171,674899,-4728
G5400470,West Virginia,McDowell County,11322,15330,-4008
G2801510,Mississippi,Washington County,21708,24567,-2859
G2002090,Kansas,Wyandotte County,66747,69102,-2355
G5400690,West Virginia,Ohio County,21172,23229,-2057
G0500930,Arkansas,Mississippi County,20459,22232,-1773
G4200210,Pennsylvania,Cambria County,65650,67374,-1724
G2200230,Louisiana,Cameron Parish,3593,5031,-1438
G4803890,Texas,Reeves County,4640,6044,-1404
G4801790,Texas,Gray County,10158,11532,-1374
G2001250,Kansas,Montgomery County,16578,17920,-1342
G2100950,Kentucky,Harlan County,13513,14735,-1222
G3900810,Ohio,Jefferson County,32826,33911,-1085
G0501070,Arkansas,Phillips County,10126,11094,-968
G1700030,Illinois,Alexander County,4006,4902,-896
G5401090,West Virginia,Wyoming County,10958,11756,-798
G4802330,Texas,Hutchinson County,10629,11419,-790
G0500170,Arkansas,Chicot County,5421,6191,-770
G4801150,Texas,Dawson County,5220,5969,-749
G4000710,Oklahoma,Kay County,21708,22456,-748
G1701830,Illinois,Vermilion County,36318,37061,-743
G4804150,Texas,Scurry County,6963,7702,-739
G0500770,Arkansas,Lee County,4356,5085,-729
G3800190,North Dakota,Cavalier County,2309,3038,-729
G2800270,Mississippi,Coahoma County,10792,11495,-703
G4804950,Texas,Winkler County,3027,3708,-681
G4804750,Texas,Ward County,4694,5365,-671
G2200350,Louisiana,East Carroll Parish,2904,3563,-659
G1701650,Illinois,Saline County,11697,12350,-653
G2901550,Missouri,Pemiscot County,8161,8806,-645
G4001410,Oklahoma,Tillman County,4077,4704,-627
G0501390,Arkansas,Union County,19653,20276,-623
G4001490,Oklahoma,Washita County,5479,6101,-622
G1701930,Illinois,White County,7181,7797,-616
G0500950,Arkansas,Monroe County,4455,5063,-608
G1701250,Illinois,Mason County,7077,7684,-607
G2800830,Mississippi,Leflore County,13199,13799,-600
G3800990,North Dakota,Walsh County,5498,6093,-595
G4000030,Oklahoma,Alfalfa County,2763,3357,-594
G2000990,Kansas,Labette County,10092,10641,-549
G1701870,Illinois,Warren County,7682,8229,-547
G2000290,Kansas,Cloud County,4659,5198,-539
G4000110,Oklahoma,Blaine County,5193,5729,-536
G4801530,Texas,Floyd County,3004,3535,-531
G4802270,Texas,Howard County,13124,13651,-527
G2000970,Kansas,Kiowa County,1220,1738,-518
G4803350,Texas,Mitchell County,4064,4559,-495
G4804870,Texas,Wilbarger County,6318,6812,-494
G0500670,Arkansas,Jackson County,7601,8086,-485
G2801330,Mississippi,Sunflower County,9685,10167,-482
G4000530,Oklahoma,Grant County,2486,2955,-469
G4804450,Texas,Terry County,4828,5296,-468
G1700590,Illinois,Gallatin County,2746,3197,-451
G2000090,Kansas,Barton County,12696,13144,-448
G0500410,Arkansas,Desha County,6261,6706,-445
G2800110,Mississippi,Bolivar County,14070,14514,-444
G3800670,North Dakota,Pembina County,3859,4294,-435
G3000710,Montana,Phillips County,2335,2765,-430
G4000750,Oklahoma,Kiowa County,5216,5645,-429
G3001050,Montana,Valley County,4879,5304,-425
G1700670,Illinois,Hancock County,9274,9692,-418
G4802750,Texas,Knox County,2044,2459,-415
G4801070,Texas,Crosby County,2902,3312,-410
G2002050,Kansas,Wilson County,4682,5091,-409
G2001570,Kansas,Republic County,2877,3283,-406
G4601150,South Dakota,Spink County,3139,3545,-406
G2001170,Kansas,Marshall County,4866,5269,-403
G4800790,Texas,Cochran County,1360,1763,-403
G4802790,Texas,Lamb County,6128,6531,-403
G2002010,Kansas,Washington County,2955,3355,-400
G4802070,Texas,Haskell County,3443,3843,-400
G1901510,Iowa,Pocahontas County,3794,4193,-399
G4805010,Texas,Yoakum County,2978,3372,-394
G3801030,North Dakota,Wells County,2481,2869,-388
G4000550,Oklahoma,Greer County,2738,3126,-388
G5400590,West Virginia,Mingo County,12699,13087,-388
G2900870,Missouri,Holt County,2806,3190,-384
G2001830,Kansas,Smith County,2232,2615,-383
G2000890,Kansas,Jewell County,2032,2409,-377
G2800530,Mississippi,Humphreys County,3855,4231,-376
G3800490,North Dakota,McHenry County,2948,3320,-372
G2900330,Missouri,Carroll County,4630,5001,-371
G2000770,Kansas,Harper County,3116,3481,-365
G2000070,Kansas,Barber County,2765,3120,-355
G3800130,North Dakota,Burke County,1340,1691,-351
G2001850,Kansas,Stafford County,2319,2666,-347
G3800230,North Dakota,Divide County,1324,1667,-343
G4800230,Texas,Baylor County,2665,3006,-341
G4804830,Texas,Wheeler County,2730,3071,-341
G4800870,Texas,Collingsworth County,1616,1952,-336
G3800630,North Dakota,Nelson County,1927,2261,-334
G0500210,Arkansas,Clay County,8031,8362,-331
G3000910,Montana,Sheridan County,2089,2417,-328
G2700430,Minnesota,Faribault County,7090,7416,-326
G4800170,Texas,Bailey County,2784,3109,-325
G3800370,North Dakota,Grant County,1690,2011,-321
G3800950,North Dakota,Towner County,1449,1770,-321
G2001590,Kansas,Rice County,4548,4868,-320
G3800090,North Dakota,Bottineau County,4341,4661,-320
G4804610,Texas,Upton County,1548,1868,-320
G4801010,Texas,Cottle County,968,1286,-318
G4600250,South Dakota,Clark County,1710,2026,-316
G2900050,Missouri,Atchison County,2985,3298,-313
G4803830,Texas,Reagan County,1372,1685,-313
G2100750,Kentucky,Fulton County,3372,3684,-312
G2900410,Missouri,Chariton County,4167,4479,-312
G3101470,Nebraska,Richardson County,4393,4704,-311
G4803530,Texas,Nolan County,7152,7462,-310
G2001350,Kansas,Ness County,1740,2048,-308
G4600670,South Dakota,Hutchinson County,3351,3657,-306
G0500690,Arkansas,Jefferson County,33006,33311,-305
G4001510,Oklahoma,Woods County,4478,4782,-304
G4803050,Texas,Lynn County,2676,2978,-302
G2801190,Mississippi,Quitman County,3589,3880,-291
G2001410,Kansas,Osborne County,2206,2496,-290
G4000430,Oklahoma,Dewey County,2445,2733,-288
G2001530,Kansas,Rawlins County,1458,1744,-286
G3101690,Nebraska,Thayer County,2731,3017,-286
G1700570,Illinois,Fulton County,16195,16480,-285
G4600370,South Dakota,Day County,3630,3914,-284
G4801250,Texas,Dickens County,1282,1564,-282
G1901090,Iowa,Kossuth County,7486,7765,-279
G0501470,Arkansas,Woodruff County,3893,4169,-276
G4804370,Texas,Swisher County,3221,3497,-276
G1900090,Iowa,Audubon County,2972,3247,-275
G3000830,Montana,Richland County,4550,4825,-275
G3101610,Nebraska,Sheridan County,2936,3211,-275
G3100210,Nebraska,Burt County,3467,3740,-273
G2000650,Kansas,Graham County,1484,1753,-269
G4601050,South Dakota,Perkins County,1739,2007,-268
G2700730,Minnesota,Lac qui Parle County,3692,3955,-263
G1700710,Illinois,Henderson County,3827,4089,-262
G2200250,Louisiana,Catahoula Parish,4877,5138,-261
G4801970,Texas,Hardeman County,2417,2678,-261
G2001450,Kansas,Pawnee County,3152,3412,-260
G2700690,Minnesota,Kittson County,2605,2865,-260
G3100890,Nebraska,Holt County,5215,5472,-257
G2001370,Kansas,Norton County,2542,2798,-256
G4803710,Texas,Pecos County,5585,5841,-256
G1701530,Illinois,Pulaski County,3155,3410,-255
G1900250,Iowa,Calhoun County,5108,5362,-254
G3000210,Montana,Dawson County,4233,4487,-254
G4000070,Oklahoma,Beaver County,2670,2923,-253
G4000570,Oklahoma,Harmon County,1544,1793,-249
G4803450,Texas,Motley County,779,1026,-247
G4801910,Texas,Hall County,1943,2189,-246
G2000390,Kansas,Decatur County,1818,2063,-245
G1901110,Iowa,Lee County,16205,16443,-238
G4600590,South Dakota,Hand County,1815,2053,-238
G2700890,Minnesota,Marshall County,4812,5049,-237
G3101290,Nebraska,Nuckolls County,2465,2699,-234
G2000470,Kansas,Edwards County,1636,1867,-231
G3100110,Nebraska,Boone County,2649,2878,-229
G4200830,Pennsylvania,McKean County,21225,21454,-229
G2000010,Kansas,Allen County,6226,6454,-228
G2701070,Minnesota,Norman County,3421,3648,-227
G1900030,Iowa,Adams County,2010,2234,-224
G2701730,Minnesota,Yellow Medicine County,4760,4983,-223
G3800410,North Dakota,Hettinger County,1414,1637,-223
G1901610,Iowa,Sac County,5429,5648,-219
G4802530,Texas,Jones County,7422,7639,-217
G3100610,Nebraska,Franklin County,1734,1950,-216
G2001470,Kansas,Phillips County,3049,3264,-215
G2001330,Kansas,Neosho County,7513,7726,-213
G3800050,North Dakota,Benson County,2950,3163,-213
G2000330,Kansas,Comanche County,1044,1256,-212
G2001630,Kansas,Rooks County,2768,2979,-211
G2600530,Michigan,Gogebic County,10795,10997,-202
G3000850,Montana,Roosevelt County,4063,4265,-202
G3100570,Nebraska,Dundy County,1125,1326,-201
G4801510,Texas,Fisher County,2212,2413,-201
G1901730,Iowa,Taylor County,3107,3307,-200
G3800390,North Dakota,Griggs County,1461,1660,-199
G1901470,Iowa,Palo Alto County,4628,4826,-198
G1900290,Iowa,Cass County,6591,6788,-197
G1900350,Iowa,Cherokee County,5777,5973,-196
G3101750,Nebraska,Valley County,2273,2469,-196
G3800450,North Dakota,LaMoure County,2238,2434,-196
G1900830,Iowa,Hardin County,8224,8419,-195
G3000870,Montana,Rosebud County,4057,4251,-194
G3100030,Nebraska,Antelope County,3284,3478,-194
G2000250,Kansas,Clark County,1135,1327,-192
G3800470,North Dakota,Logan County,1144,1335,-191
G4800690,Texas,Castro County,3166,3357,-191
G2801250,Mississippi,Sharkey County,2100,2290,-190
G2201150,Louisiana,Vernon Parish,21433,21622,-189
G3100590,Nebraska,Fillmore County,2913,3102,-189
G4801950,Texas,Hansford County,2338,2525,-187
G4803170,Texas,Martin County,1852,2039,-187
G0800090,Colorado,Baca County,2248,2434,-186
G1700610,Illinois,Greene County,6389,6575,-186
G3100650,Nebraska,Furnas County,2721,2905,-184
G4000930,Oklahoma,Major County,3671,3855,-184
G2002070,Kansas,Woodson County,2022,2199,-177
G1900710,Iowa,Fremont County,3431,3607,-176
G2000730,Kansas,Greenwood County,4068,4243,-175
G3800510,North Dakota,McIntosh County,1858,2031,-173
G2000710,Kansas,Greeley County,629,801,-172
G3100350,Nebraska,Clay County,3001,3173,-172
G3800750,North Dakota,Renville County,1386,1558,-172
G4802950,Texas,Lipscomb County,1512,1683,-171
G0500730,Arkansas,Lafayette County,4353,4523,-170
G2000230,Kansas,Cheyenne County,1518,1687,-169
G2001670,Kansas,Russell County,3910,4079,-169
G2001950,Kansas,Trego County,1682,1851,-169
G4000590,Oklahoma,Harper County,1908,2077,-169
G3800830,North Dakota,Sheridan County,894,1061,-167
G4600970,South Dakota,Miner County,1308,1474,-166
G3100950,Nebraska,Jefferson County,3918,4082,-164
G3200210,Nevada,Mineral County,2830,2994,-164
G4000450,Oklahoma,Ellis County,2285,2449,-164
G4601070,South Dakota,Potter County,1500,1664,-164
G4800750,Texas,Childress County,2883,3046,-163
G4801030,Texas,Crane County,1632,1795,-163
G4801290,Texas,Donley County,2142,2304,-162
G1900730,Iowa,Greene County,4546,4707,-161
G1901450,Iowa,Page County,7181,7339,-158
G4804330,Texas,Stonewall County,928,1085,-157
G1900630,Iowa,Emmet County,4758,4914,-156
G3800690,North Dakota,Pierce County,2199,2355,-156
G4600090,South Dakota,Bon Homme County,2931,3087,-156
G5400290,West Virginia,Hancock County,14541,14697,-156
G4601110,South Dakota,Sanborn County,1172,1326,-154
G3000550,Montana,McCone County,1008,1161,-153
G4600490,South Dakota,Faulk County,1136,1286,-150
G3100410,Nebraska,Custer County,5579,5728,-149
G4801090,Texas,Culberson County,1137,1286,-149
G3100150,Nebraska,Boyd County,1390,1538,-148
G4600890,South Dakota,McPherson County,1418,1566,-148
G2701550,Minnesota,Traverse County,2073,2220,-147
G3800270,North Dakota,Eddy County,1323,1470,-147
G4000670,Oklahoma,Jefferson County,3378,3522,-144
G4001290,Oklahoma,Roger Mills County,1905,2048,-143
G3101730,Nebraska,Thurston County,2408,2548,-140
G3800910,North Dakota,Steele County,1171,1311,-140
G0500010,Arkansas,Arkansas County,9436,9575,-139
G2800550,Mississippi,Issaquena County,560,698,-138
G2901150,Missouri,Linn County,6429,6566,-137
G2002030,Kansas,Wichita County,1054,1190,-136
G3101810,Nebraska,Webster County,1912,2048,-136
G4000330,Oklahoma,Cotton County,3016,3152,-136
G2700630,Minnesota,Jackson County,4990,5121,-131
G2001650,Kansas,Rush County,1869,1999,-130
G5400390,West Virginia,Kanawha County,92618,92747,-129
G2001010,Kansas,Lane County,990,1117,-127
G3800010,North Dakota,Adams County,1377,1504,-127
G3800210,North Dakota,Dickey County,2636,2763,-127
G4800810,Texas,Coke County,2667,2793,-126
G1900690,Iowa,Franklin County,4894,5018,-124
G1901370,Iowa,Montgomery County,5239,5363,-124
G1901850,Iowa,Wayne County,3212,3334,-122
G4803070,Texas,McCulloch County,4302,4424,-122
G2000630,Kansas,Gove County,1373,1494,-121
G4600410,South Dakota,Dewey County,2002,2123,-121
G4800450,Texas,Briscoe County,953,1074,-121
G5600270,Wyoming,Niobrara County,1338,1456,-118
G1700130,Illinois,Calhoun County,2835,2951,-116
G3200090,Nevada,Esmeralda County,850,966,-116
G3800290,North Dakota,Emmons County,2085,2200,-115
G2001710,Kansas,Scott County,2193,2305,-112
G4600730,South Dakota,Jerauld County,1070,1182,-112
G2000130,Kansas,Brown County,4779,4890,-111
G3100870,Nebraska,Hitchcock County,1763,1873,-110
G4600750,South Dakota,Jones County,589,699,-110
G4804430,Texas,Terrell County,700,810,-110
G3000190,Montana,Daniels County,1111,1220,-109
G0800170,Colorado,Cheyenne County,975,1083,-108
G4600690,South Dakota,Hyde County,708,816,-108
G1901970,Iowa,Wright County,6529,6636,-107
G1701490,Illinois,Pike County,7951,8057,-106
G2001510,Kansas,Pratt County,4514,4620,-106
G4600910,South Dakota,Marshall County,2534,2640,-106
G5400450,West Virginia,Logan County,16743,16848,-105
G4000250,Oklahoma,Cimarron County,1587,1690,-103
G4801550,Texas,Foard County,789,890,-101
G1901590,Iowa,Ringgold County,2613,2713,-100
G2000190,Kansas,Chautauqua County,2150,2249,-99
G3800030,North Dakota,Barnes County,5704,5801,-97
G2000270,Kansas,Clay County,4042,4138,-96
G3000410,Montana,Hill County,7250,7345,-95
G1901070,Iowa,Keokuk County,4931,5024,-93
G4800330,Texas,Borden County,385,478,-93
G4600530,South Dakota,Gregory County,2503,2595,-92
G0800110,Colorado,Bent County,2242,2332,-90
G2900790,Missouri,Grundy County,5023,5113,-90
G2901290,Missouri,Mercer County,2135,2225,-90
G3101490,Nebraska,Rock County,912,1001,-89
G3101230,Nebraska,Morrill County,2442,2530,-88
G3500210,New Mexico,Harding County,526,614,-88
G3800530,North Dakota,McKenzie County,3090,3178,-88
G2701290,Minnesota,Renville County,7355,7442,-87
G3000050,Montana,Blaine County,2843,2930,-87
G3101350,Nebraska,Perkins County,1450,1537,-87
G3101330,Nebraska,Pawnee County,1588,1674,-86
G3100170,Nebraska,Brown County,1865,1950,-85
G0501030,Arkansas,Ouachita County,13121,13204,-83
G2700330,Minnesota,Cottonwood County,5412,5495,-83
G4802110,Texas,Hemphill County,1629,1712,-83
G3000330,Montana,Garfield County,844,924,-80
G4803110,Texas,McMullen County,485,565,-80
G2000530,Kansas,Ellsworth County,3239,3317,-78
G4600430,South Dakota,Douglas County,1439,1517,-78
G2700110,Minnesota,Big Stone County,3115,3192,-77
G3000790,Montana,Prairie County,673,749,-76
G3800310,North Dakota,Foster County,1801,1876,-75
G4801170,Texas,Deaf Smith County,7077,7152,-75
G3000750,Montana,Powder River County,1022,1096,-74
G0800610,Colorado,Kiowa County,805,878,-73
G1700470,Illinois,Edwards County,3187,3260,-73
G3100850,Nebraska,Hayes County,511,583,-72
G4600950,South Dakota,Mellette County,838,910,-72
G4800650,Texas,Carson County,2784,2856,-72
G2902050,Missouri,Shelby County,3206,3277,-71
G0101050,Alabama,Perry County,4737,4807,-70
G3800330,North Dakota,Golden Valley County,967,1035,-68
G3100290,Nebraska,Chase County,1946,2011,-65
G2001230,Kansas,Mitchell County,3296,3359,-63
G3800650,North Dakota,Oliver County,905,968,-63
G2701670,Minnesota,Wilkin County,3078,3140,-62
G2001790,Kansas,Sheridan County,1265,1324,-59
G2001990,Kansas,Wallace County,781,840,-59
G2800010,Mississippi,Adams County,14656,14715,-59
G4600550,South Dakota,Haakon County,1013,1071,-58
G3100130,Nebraska,Box Butte County,5478,5534,-56
G0501230,Arkansas,St. Francis County,10903,10958,-55
G2701010,Minnesota,Murray County,4556,4611,-55
G3000250,Montana,Fallon County,1470,1525,-55
G3100090,Nebraska,Blaine County,326,381,-55
G4600610,South Dakota,Hanson County,1177,1232,-55
G3101650,Nebraska,Sioux County,815,869,-54
G3800810,North Dakota,Sargent County,2004,2057,-53
G4803930,Texas,Roberts County,439,492,-53
G2001190,Kansas,Meade County,1998,2049,-51
G4802630,Texas,Kent County,552,603,-51
G4000150,Oklahoma,Caddo County,13141,13191,-50
G2000830,Kansas,Hodgeman County,973,1022,-49
G3800070,North Dakota,Billings County,484,533,-49
G2001290,Kansas,Morton County,1467,1515,-48
G4000650,Oklahoma,Jackson County,12077,12125,-48
G1900930,Iowa,Ida County,3426,3473,-47
G4803990,Texas,Runnels County,5298,5345,-47
G2901330,Missouri,Mississippi County,5711,5757,-46
G3800570,North Dakota,Mercer County,4450,4496,-46
G3800870,North Dakota,Slope County,436,481,-45
G4600630,South Dakota,Harding County,731,776,-45
G4600770,South Dakota,Kingsbury County,2720,2765,-45
G1701010,Illinois,Lawrence County,6936,6980,-44
G2000170,Kansas,Chase County,1503,1547,-44
G4804290,Texas,Stephens County,4938,4982,-44
G1701750,Illinois,Stark County,2674,2716,-42
G1901150,Iowa,Louisa County,5002,5044,-42
G4804210,Texas,Sherman County,1252,1293,-41
G0800570,Colorado,Jackson County,1286,1326,-40
G4600450,South Dakota,Edmunds County,1966,2004,-38
G3101030,Nebraska,Keya Paha County,549,584,-35
G2700230,Minnesota,Chippewa County,5721,5755,-34
G3100750,Nebraska,Grant County,391,425,-34
G3100830,Nebraska,Harlan County,2375,2409,-34
G2101050,Kentucky,Hickman County,2342,2374,-32
G3100490,Nebraska,Deuel County,1044,1075,-31
G4801050,Texas,Crockett County,1866,1897,-31
G2001810,Kansas,Sherman County,3148,3177,-29
G3100690,Nebraska,Garden County,1314,1343,-29
G4600070,South Dakota,Bennett County,1263,1292,-29
G1901870,Iowa,Webster County,17035,17063,-28
G4804470,Texas,Throckmorton County,1079,1106,-27
G2901430,Missouri,New Madrid County,8531,8557,-26
G3001030,Montana,Treasure County,422,448,-26
G2001090,Kansas,Logan County,1441,1466,-25
G3001090,Montana,Wibaux County,538,563,-25
G2900750,Missouri,Gentry County,3209,3232,-23
G4600510,South Dakota,Grant County,3526,3549,-23
G3500230,New Mexico,Hidalgo County,2393,2413,-20
G4801730,Texas,Glasscock County,580,600,-20
G4803590,Texas,Oldham County,841,861,-20
G2200650,Louisiana,Madison Parish,4804,4823,-19
G3001010,Montana,Toole County,2336,2354,-18
G4600030,South Dakota,Aurora County,1324,1342,-18
G4600310,South Dakota,Corson County,1540,1557,-17
G1900010,Iowa,Adair County,3698,3714,-16
G4803910,Texas,Refugio County,3726,3739,-13
G3101450,Nebraska,Red Willow County,5267,5279,-12
G4700950,Tennessee,Lake County,2598,2610,-12
G4800110,Texas,Armstrong County,904,916,-12
G3101070,Nebraska,Knox County,4788,4799,-11
G3101430,Nebraska,Polk County,2731,2742,-11
G3200150,Nevada,Lander County,2575,2586,-11
G3000450,Montana,Judith Basin County,1336,1346,-10
G4801450,Texas,Falls County,7724,7733,-9
G4803010,Texas,Loving County,50,59,-9
G1901430,Iowa,Osceola County,2990,2998,-8
G3800110,North Dakota,Bowman County,1683,1691,-8
G4804310,Texas,Sterling County,615,623,-8
G3500370,New Mexico,Quay County,5569,5576,-7
G3000110,Montana,Carter County,810,816,-6
G3101250,Nebraska,Nance County,1801,1807,-6
G2000930,Kansas,Kearny County,1556,1561,-5
G4802690,Texas,King County,186,191,-5
G3101050,Nebraska,Kimball County,1963,1967,-4
G4001150,Oklahoma,Ottawa County,14060,14064,-4
G4600390,South Dakota,Deuel County,2204,2208,-4
G3100910,Nebraska,Hooker County,431,433,-2
G3101710,Nebraska,Thomas County,402,404,-2
G3100270,Nebraska,Cedar County,4148,4149,-1
G3800710,North Dakota,Ramsey County,5615,5616,-1
G4804170,Texas,Shackelford County,1754,1755,-1
G0800790,Colorado,Mineral County,1201,1201,0
G2001050,Kansas,Lincoln County,1864,1864,0
G0801150,Colorado,Sedgwick County,1415,1414,1
G2001930,Kansas,Thomas County,3536,3534,2
G3800430,North Dakota,Kidder County,1674,1672,2
G3100070,Nebraska,Banner County,369,366,3
G3500590,New Mexico,Union County,2305,2299,6
G3101130,Nebraska,Logan County,395,387,8
G3100630,Nebraska,Frontier County,1574,1565,9
G3800970,North Dakota,Traill County,3780,3770,10
G1302730,Georgia,Terrell County,4080,4069,11
G2902270,Missouri,Worth County,1281,1269,12
G3100050,Nebraska,Arthur County,254,242,12
G1701850,Illinois,Wabash County,5585,5572,13
G1900910,Iowa,Humboldt County,4684,4670,14
G4802190,Texas,Hockley County,9293,9279,14
G4802350,Texas,Irion County,856,842,14
G3101830,Nebraska,Wheeler County,576,561,15
G3500110,New Mexico,De Baca County,1344,1329,15
G3100770,Nebraska,Greeley County,1300,1284,16
G1701710,Illinois,Scott County,2459,2442,17
G2000490,Kansas,Elk County,1760,1743,17
G4100550,Oregon,Sherman County,918,900,18
G4802610,Texas,Kenedy County,233,213,20
G2000750,Kansas,Hamilton County,1236,1214,22
G2102330,Kentucky,Webster County,5936,5914,22
G1900470,Iowa,Crawford County,6943,6920,23
G2201070,Louisiana,Tensas Parish,3357,3334,23
G5300230,Washington,Garfield County,1233,1209,24
G3101170,Nebraska,McPherson County,283,257,26
G3101150,Nebraska,Loup County,426,399,27
G1600330,Idaho,Clark County,531,502,29
G3000690,Montana,Petroleum County,324,293,31
G2001870,Kansas,Stanton County,990,956,34
G4601190,South Dakota,Sully County,845,811,34
G0100110,Alabama,Bullock County,4493,4458,35
G2901030,Missouri,Knox County,2289,2254,35
G3000510,Montana,Liberty County,1043,1007,36
G4600210,South Dakota,Campbell County,980,944,36
G2801350,Mississippi,Tallahatchie County,5530,5492,38
G3100970,Nebraska,Johnson County,2191,2153,38
G2701510,Minnesota,Swift County,4835,4795,40
G3000730,Montana,Pondera County,2659,2618,41
G3000370,Montana,Golden Valley County,476,432,44
G5401030,West Virginia,Wetzel County,8173,8129,44
G3101390,Nebraska,Pierce County,3222,3177,45
G4600710,South Dakota,Jackson County,1193,1147,46
G1700790,Illinois,Jasper County,4345,4297,48
G2701250,Minnesota,Red Lake County,1948,1899,49
G4601230,South Dakota,Tripp County,3072,3023,49
G2102250,Kentucky,Union County,6141,6091,50
G2701490,Minnesota,Stevens County,4160,4108,52
G4801690,Texas,Garza County,2237,2184,53
G3100730,Nebraska,Gosper County,1267,1212,55
G4200230,Pennsylvania,Cameron County,4455,4399,56
G4801370,Texas,Edwards County,1606,1550,56
G2001270,Kansas,Morris County,3206,3149,57
G2700810,Minnesota,Lincoln County,3108,3050,58
G1901170,Iowa,Lucas County,4238,4179,59
G3101270,Nebraska,Nemaha County,3498,3432,66
G4803570,Texas,Ochiltree County,4062,3996,66
G2901990,Missouri,Scotland County,2369,2302,67
G3101630,Nebraska,Sherman County,1941,1874,67
G3001070,Montana,Wheatland County,1197,1129,68
G1700450,Illinois,Edgar County,8803,8733,70
G3100390,Nebraska,Cuming County,4204,4132,72
G4600170,South Dakota,Buffalo County,609,535,74
G2700710,Minnesota,Koochiching County,7900,7825,75
G2900450,Missouri,Clark County,3473,3398,75
G3100510,Nebraska,Dixon County,2688,2613,75
G3800250,North Dakota,Dunn County,2132,2057,75
G3800550,North Dakota,McLean County,5590,5515,75
G4601290,South Dakota,Walworth County,3003,2928,75
G2000810,Kansas,Haskell County,1666,1586,80
G2901950,Missouri,Saline County,10117,10033,84
G1700690,Illinois,Hardin County,2488,2403,85
G4000290,Oklahoma,Coal County,2810,2725,85
G0800990,Colorado,Prowers County,5942,5855,87
G3800730,North Dakota,Ransom County,2656,2569,87
G1600230,Idaho,Butte County,1354,1265,89
G5300130,Washington,Columbia County,2136,2046,90
G1700650,Illinois,Hamilton County,4104,4013,91
G3101370,Nebraska,Phelps County,4175,4084,91
G3800930,North Dakota,Stutsman County,9862,9770,92
G1900810,Iowa,Hancock County,5330,5236,94
G1700550,Illinois,Franklin County,18525,18430,95
G2001910,Kansas,Sumner County,10865,10769,96
G2701170,Minnesota,Pipestone County,4483,4387,96
G1900210,Iowa,Buena Vista County,8237,8140,97
G4600230,South Dakota,Charles Mix County,3849,3751,98
G4804110,Texas,San Saba County,3177,3078,99
G4805030,Texas,Young County,8622,8523,99
G5600430,Wyoming,Washakie County,3833,3732,101
G4805070,Texas,Zavala County,4283,4180,103
G1800070,Indiana,Benton County,3937,3833,104
G2100250,Kentucky,Breathitt County,6231,6127,104
G3000270,Montana,Fergus County,5836,5732,104
G1700090,Illinois,Brown County,2462,2357,105
G1901950,Iowa,Worth County,3548,3443,105
G4804350,Texas,Sutton County,2031,1924,107
G2200670,Louisiana,Morehouse Parish,12423,12314,109
G3800770,North Dakota,Richland County,7503,7394,109
G1901650,Iowa,Shelby County,5542,5430,112
G4100690,Oregon,Wheeler County,895,782,113
G1701310,Illinois,Mercer County,7358,7244,114
G4803690,Texas,Parmer County,3799,3685,114
G2901970,Missouri,Schuyler County,2102,1986,116
G4802710,Texas,Kinney County,1940,1821,119
G4600870,South Dakota,McCook County,2491,2371,120
G4800950,Texas,Concho County,1637,1514,123
G2800210,Mississippi,Claiborne County,4223,4099,124
G3100370,Nebraska,Colfax County,4097,3971,126
G0800950,Colorado,Phillips County,2087,1960,127
G0801210,Colorado,Washington County,2434,2307,127
G2701270,Minnesota,Redwood County,7272,7144,128
G1302650,Georgia,Taliaferro County,1015,886,129
G5400090,West Virginia,Brooke County,10967,10838,129
G1701690,Illinois,Schuyler County,3459,3329,130
G3100990,Nebraska,Kearney County,2886,2756,130
G0800530,Colorado,Hinsdale County,1388,1254,134
G1700250,Illinois,Clay County,6404,6270,134
G3100310,Nebraska,Cherry County,3157,3023,134
G4800470,Texas,Brooks County,3239,3104,135
G3800850,North Dakota,Sioux County,1311,1175,136
G1600790,Idaho,Shoshone County,7061,6923,138
G1700170,Illinois,Cass County,5836,5698,138
G4601250,South Dakota,Turner County,3939,3800,139
G2102010,Kentucky,Robertson County,1095,955,140
G4803270,Texas,Menard County,1702,1562,140
G1901770,Iowa,Van Buren County,3670,3529,141
G1900530,Iowa,Decatur County,3834,3692,142
G1901330,Iowa,Monona County,4697,4555,142
G0800250,Colorado,Crowley County,1559,1415,144
G1901350,Iowa,Monroe County,3884,3740,144
G2100390,Kentucky,Carlisle County,2441,2295,146
G2700510,Minnesota,Grant County,3324,3178,146
G1300070,Georgia,Baker County,1652,1499,153
G4801190,Texas,Delta County,2458,2305,153
G5600170,Wyoming,Hot Springs County,2582,2429,153
G3000170,Montana,Custer County,5560,5405,155
G3100710,Nebraska,Garfield County,1178,1021,157
G2600710,Michigan,Iron County,9197,9039,158
G4600150,South Dakota,Brule County,2433,2275,158
G4601010,South Dakota,Moody County,2824,2666,158
G2701650,Minnesota,Watonwan County,5047,4886,161
G3701770,North Carolina,Tyrrell County,2068,1907,161
G4800830,Texas,Coleman County,5543,5382,161
G0600910,California,Sierra County,2328,2166,162
G2700910,Minnesota,Martin County,10009,9847,162
G2900810,Missouri,Harrison County,4407,4245,162
G4000630,Oklahoma,Hughes County,6183,6021,162
G0501170,Arkansas,Prairie County,4503,4340,163
G1700530,Illinois,Ford County,6282,6118,164
G1901890,Iowa,Winnebago County,5194,5030,164
G2200750,Louisiana,Plaquemines Parish,9596,9432,164
G3101210,Nebraska,Merrick County,3698,3533,165
G3000990,Montana,Teton County,2892,2725,167
G1701210,Illinois,Marion County,18296,18123,173
G1901410,Iowa,O'Brien County,6649,6476,173
G2000950,Kansas,Kingman County,3818,3645,173
G3000590,Montana,Meagher County,1432,1259,173
G4803870,Texas,Red River County,6826,6650,176
G4601090,South Dakota,Roberts County,4905,4728,177
G4600850,South Dakota,Lyman County,1704,1523,181
G4601370,South Dakota,Ziebach County,987,800,187
G2001430,Kansas,Ottawa County,2779,2591,188
G1302010,Georgia,Miller County,2791,2602,189
G2001890,Kansas,Stevens County,2306,2116,190
G1701450,Illinois,Perry County,9426,9235,191
G2101890,Kentucky,Owsley County,2328,2137,191
G1900370,Iowa,Chickasaw County,5679,5486,193
G4900310,Utah,Piute County,898,704,194
G1800090,Indiana,Blackford County,6051,5856,195
G1700330,Illinois,Crawford County,8661,8464,197
G1600610,Idaho,Lewis County,1880,1681,199
G1900230,Iowa,Butler County,6682,6483,199
G1801650,Indiana,Vermillion County,7488,7288,200
G4804130,Texas,Schleicher County,1489,1288,201
G5400210,West Virginia,Gilmer County,3448,3243,205
G2000030,Kansas,Anderson County,3720,3514,206
G2800970,Mississippi,Montgomery County,5194,4987,207
G2600830,Michigan,Keweenaw County,2467,2257,210
G3000150,Montana,Chouteau County,2879,2668,211
G4600050,South Dakota,Beadle County,8304,8093,211
G1900890,Iowa,Howard County,4367,4155,212
G5400150,West Virginia,Clay County,4572,4359,213
G2201230,Louisiana,West Carroll Parish,5046,4831,215
G0800730,Colorado,Lincoln County,2420,2204,216
G2101490,Kentucky,McLean County,4264,4042,222
G4100210,Oregon,Gilliam County,1156,932,224
G4803430,Texas,Morris County,6024,5800,224
G2000690,Kansas,Gray County,2340,2114,226
G1302590,Georgia,Stewart County,2383,2156,227
G2201270,Louisiana,Winn Parish,7234,7006,228
G0800890,Colorado,Otero County,8969,8739,230
G1900070,Iowa,Appanoose County,6633,6402,231
G1301630,Georgia,Jefferson County,7298,7065,233
G1900510,Iowa,Davis County,3600,3365,235
G4001330,Oklahoma,Seminole County,11642,11404,238
G2000430,Kansas,Doniphan County,3576,3337,239
G4802290,Texas,Hudspeth County,1527,1288,239
G2101310,Kentucky,Leslie County,5278,5038,240
G0101190,Alabama,Sumter County,6786,6545,241
G1600770,Idaho,Power County,2944,2701,243
G2001310,Kansas,Nemaha County,4562,4319,243
G3500190,New Mexico,Guadalupe County,2393,2149,244
G4500050,South Carolina,Allendale County,4486,4242,244
G2000110,Kansas,Bourbon County,7167,6920,247
G1801250,Indiana,Pike County,5735,5487,248
G2200270,Louisiana,Claiborne Parish,7761,7513,248
G4801110,Texas,Dallam County,2827,2577,250
G2000310,Kansas,Coffey County,3964,3712,252
G3100230,Nebraska,Butler County,4053,3801,252
G0500390,Arkansas,Dallas County,4305,4049,256
G5400730,West Virginia,Pleasants County,3390,3134,256
G3101790,Nebraska,Wayne County,3776,3517,259
G3200110,Nevada,Eureka County,1076,817,259
G4600570,South Dakota,Hamlin County,2760,2500,260
G1300990,Georgia,Early County,4975,4714,261
G4803210,Texas,Matagorda County,18801,18540,261
G4803330,Texas,Mills County,2846,2582,264
G2902110,Missouri,Sullivan County,3358,3093,265
G4802430,Texas,Jeff Davis County,1613,1348,265
G1300530,Georgia,Chattahoochee County,3376,3108,268
G3000770,Montana,Powell County,3105,2835,270
G1701890,Illinois,Washington County,6534,6261,273
G0801110,Colorado,San Juan County,756,481,275
G0500990,Arkansas,Nevada County,4563,4287,276
G3101670,Nebraska,Stanton County,2633,2355,278
G2700870,Minnesota,Mahnomen County,2786,2505,281
G3801050,North Dakota,Williams County,10464,10180,284
G1900570,Iowa,Des Moines County,18535,18248,287
G1901190,Iowa,Lyon County,4848,4561,287
G2001150,Kansas,Marion County,5946,5659,287
G5400510,West Virginia,Marshall County,15918,15630,288
G0500810,Arkansas,Little River County,6460,6171,289
G2200810,Louisiana,Red River Parish,4128,3839,289
G2901110,Missouri,Lewis County,4535,4244,291
G3000230,Montana,Deer Lodge County,5122,4830,292
G1900670,Iowa,Floyd County,7526,7233,293
G4001050,Oklahoma,Nowata County,4828,4534,294
G1900650,Iowa,Fayette County,9558,9262,296
G2000050,Kansas,Atchison County,6990,6691,299
G2701330,Minnesota,Rock County,4262,3963,299
G4801930,Texas,Hamilton County,4566,4266,300
G0800630,Colorado,Kit Carson County,3527,3224,303
G0500750,Arkansas,Lawrence County,8000,7692,308
G1800830,Indiana,Knox County,17038,16730,308
G1901750,Iowa,Union County,5937,5622,315
G2200410,Louisiana,Franklin Parish,9034,8719,315
G4200530,Pennsylvania,Forest County,8760,8445,315
G1800750,Indiana,Jay County,9221,8905,316
G4900090,Utah,Daggett County,1141,825,316
G0500030,Arkansas,Ashley County,10137,9820,317
G2900690,Missouri,Dunklin County,14419,14102,317
G2101710,Kentucky,Monroe County,5204,4882,322
G4001530,Oklahoma,Woodward County,8838,8512,326
G4000470,Oklahoma,Garfield County,26831,26502,329
G2101810,Kentucky,Nicholas County,3261,2930,331
G4601170,South Dakota,Stanley County,1387,1056,331
G5600030,Wyoming,Big Horn County,5379,5048,331
G2100070,Kentucky,Ballard County,3885,3553,332
G2701190,Minnesota,Polk County,14610,14275,335
G1303190,Georgia,Wilkinson County,4487,4151,336
G1901310,Iowa,Mitchell County,4850,4514,336
G4200470,Pennsylvania,Elk County,17585,17249,336
G1701510,Illinois,Pope County,2491,2154,337
G4001170,Oklahoma,Pawnee County,7745,7407,338
G4802470,Texas,Jim Hogg County,2441,2103,338
G1900790,Iowa,Hamilton County,7219,6879,340
G2200290,Louisiana,Concordia Parish,9383,9043,340
G2601310,Michigan,Ontonagon County,5672,5332,340
G3100450,Nebraska,Dawes County,4252,3909,343
G2000670,Kansas,Grant County,2945,2599,346
G0100850,Alabama,Lowndes County,5140,4792,348
G1300370,Georgia,Calhoun County,2409,2061,348
G1901710,Iowa,Tama County,7766,7417,349
G1600250,Idaho,Camas County,831,481,350
G4800030,Texas,Andrews County,5814,5462,352
G1701910,Illinois,Wayne County,7975,7622,353
G3100930,Nebraska,Howard County,2951,2598,353
G4100630,Oregon,Wallowa County,4108,3755,353
G1700950,Illinois,Knox County,24077,23722,355
G5401010,West Virginia,Webster County,5428,5072,356
G1600290,Idaho,Caribou County,3226,2867,359
G4801270,Texas,Dimmit County,4350,3991,359
G5400050,West Virginia,Boone County,11070,10705,365
G3101850,Nebraska,York County,6231,5861,370
G1701590,Illinois,Richland County,7513,7142,371
G1900750,Iowa,Grundy County,5530,5158,372
G1800410,Indiana,Fayette County,10898,10525,373
G4801890,Texas,Hale County,13541,13168,373
G2001970,Kansas,Wabaunsee County,3227,2853,374
G4803190,Texas,Mason County,2733,2356,377
G3100810,Nebraska,Hamilton County,3968,3589,379
G0801250,Colorado,Yuma County,4466,4082,384
G5600070,Wyoming,Carbon County,8576,8190,386
G4001070,Oklahoma,Okfuskee County,5282,4894,388
G3000030,Montana,Big Horn County,4695,4304,391
G2901710,Missouri,Putnam County,2982,2590,392
G4801310,Texas,Duval County,5523,5127,396
G1900410,Iowa,Clay County,8062,7659,403
G1801710,Indiana,Warren County,3680,3275,405
G4802050,Texas,Hartley County,1946,1541,405
G1600710,Idaho,Oneida County,1906,1496,410
G2101290,Kentucky,Lee County,3436,3025,411
G4600790,South Dakota,Lake County,5559,5148,411
G1302870,Georgia,Turner County,3841,3426,415
G1801350,Indiana,Randolph County,11743,11327,416
G5600150,Wyoming,Goshen County,5972,5551,421
G2900570,Missouri,Dade County,3965,3543,422
G1700350,Illinois,Cumberland County,4874,4448,426
G1701150,Illinois,Macon County,50475,50049,426
G1801610,Indiana,Union County,3239,2813,426
G4800090,Texas,Archer County,4107,3680,427
G2901170,Missouri,Livingston County,6730,6294,436
G5401050,West Virginia,Wirt County,3231,2795,436
G1900450,Iowa,Clinton County,21733,21296,437
G2100190,Kentucky,Boyd County,21803,21365,438
G0100870,Alabama,Macon County,10259,9818,441
G0600030,California,Alpine County,1760,1319,441
G2701050,Minnesota,Nobles County,8535,8094,441
G4800250,Texas,Bee County,10649,10208,441
G3700950,North Carolina,Hyde County,3347,2905,442
G4800770,Texas,Clay County,5150,4708,442
G2800510,Mississippi,Holmes County,8415,7972,443
G5600450,Wyoming,Weston County,3533,3090,443
G3800610,North Dakota,Mountrail County,4119,3675,444
G4001030,Oklahoma,Noble County,5341,4894,447
G2700470,Minnesota,Freeborn County,14231,13783,448
G1801530,Indiana,Sullivan County,8939,8487,452
G1901790,Iowa,Wapello County,16098,15640,458
G0500130,Arkansas,Calhoun County,2897,2437,460
G3600410,New York,Hamilton County,8694,8234,460
G2000350,Kansas,Cowley County,16030,15569,461
G2200210,Louisiana,Caldwell Parish,4994,4533,461
G2000210,Kansas,Cherokee County,9890,9428,462
G3101510,Nebraska,Saline County,5762,5299,463
G2101590,Kentucky,Martin County,5164,4697,467
G1701070,Illinois,Logan County,12107,11638,469
G3000650,Montana,Musselshell County,2654,2183,471
G1701550,Illinois,Putnam County,3074,2600,474
G1303090,Georgia,Wheeler County,2625,2148,477
G2801550,Mississippi,Webster County,4804,4326,478
G4200590,Pennsylvania,Greene County,16460,15982,478
G0100230,Alabama,Choctaw County,7269,6789,480
G1301250,Georgia,Glascock County,1519,1036,483
G3101010,Nebraska,Keith County,5424,4938,486
G1900390,Iowa,Clarke County,4086,3599,487
G2001750,Kansas,Seward County,8061,7572,489
G4803150,Texas,Marion County,6218,5729,489
G4801330,Texas,Eastland County,10258,9768,490
G1801390,Indiana,Rush County,7508,7014,494
G2901790,Missouri,Reynolds County,4033,3537,496
G2100330,Kentucky,Caldwell County,6292,5794,498
G4600470,South Dakota,Fall River County,4191,3692,499
G4800930,Texas,Comanche County,7223,6724,499
G4802830,Texas,La Salle County,2746,2244,502
G4201210,Pennsylvania,Venango County,27464,26961,503
G5400410,West Virginia,Lewis County,7958,7454,504
G0801030,Colorado,Rio Blanco County,3309,2803,506
G2800630,Mississippi,Jefferson County,3673,3167,506
G3000970,Montana,Sweet Grass County,2148,1639,509
G5500780,Wisconsin,Menominee County,2253,1742,511
G1300610,Georgia,Clay County,2102,1586,516
G1701810,Illinois,Union County,7924,7408,516
G3200330,Nevada,White Pine County,4498,3982,516
G2800170,Mississippi,Chickasaw County,7514,6997,517
G5400130,West Virginia,Calhoun County,3963,3446,517
G1801310,Indiana,Pulaski County,6060,5541,519
G0600490,California,Modoc County,5192,4672,520
G0800330,Colorado,Dolores County,1468,947,521
G1800450,Indiana,Fountain County,7865,7344,521
G2801030,Mississippi,Noxubee County,5170,4645,525
G2801630,Mississippi,Yazoo County,10074,9549,525
G1701570,Illinois,Randolph County,13707,13179,528
G0101310,Alabama,Wilcox County,5649,5119,530
G2100550,Kentucky,Crittenden County,4569,4039,530
G4000090,Oklahoma,Beckham County,9647,9117,530
G4100250,Oregon,Harney County,3835,3305,530
G4900550,Utah,Wayne County,1591,1061,530
G4802550,Texas,Karnes County,5650,5117,533
G1800530,Indiana,Grant County,30443,29904,539
G2800650,Mississippi,Jefferson Davis County,5876,5336,540
G1303010,Georgia,Warren County,2985,2443,542
G3100330,Nebraska,Cheyenne County,4888,4345,543
G4802970,Texas,Live Oak County,6065,5519,546
G4803850,Texas,Real County,2599,2049,550
G3000350,Montana,Glacier County,5348,4797,551
G1301550,Georgia,Irwin County,4033,3479,554
G2900350,Missouri,Carter County,3247,2693,554
G1302830,Georgia,Treutlen County,2992,2437,555
G1900850,Iowa,Harrison County,6731,6175,556
G3200270,Nevada,Pershing County,2464,1908,556
G2000410,Kansas,Dickinson County,8972,8415,557
G2900890,Missouri,Howard County,4582,4025,557
G5400950,West Virginia,Tyler County,5000,4441,559
G4900150,Utah,Emery County,4489,3928,561
G0500790,Arkansas,Lincoln County,4860,4295,565
G4000390,Oklahoma,Custer County,12204,11636,568
G4100230,Oregon,Grant County,4344,3774,570
G4601210,South Dakota,Todd County,3142,2572,570
G1801590,Indiana,Tipton County,6998,6427,571
G2800690,Mississippi,Kemper County,4722,4151,571
G5300690,Washington,Wahkiakum County,2067,1496,571
G1900770,Iowa,Guthrie County,5756,5179,577
G1700390,Illinois,De Witt County,7521,6942,579
G2901750,Missouri,Randolph County,10714,10131,583
G1300650,Georgia,Clinch County,3007,2423,584
G2100130,Kentucky,Bell County,13154,12568,586
G2600130,Michigan,Baraga County,5270,4684,586
G2900110,Missouri,Barton County,5600,5014,586
G2900610,Missouri,Daviess County,4199,3613,586
G1302890,Georgia,Twiggs County,4235,3648,587
G1600630,Idaho,Lincoln County,1976,1386,590
G2200830,Louisiana,Richland Parish,8621,8031,590
G2200590,Louisiana,La Salle Parish,6560,5969,591
G1701230,Illinois,Marshall County,5914,5317,597
G4802370,Texas,Jack County,4095,3497,598
G0500370,Arkansas,Cross County,7853,7254,599
G2701210,Minnesota,Pope County,6435,5836,599
G2800370,Mississippi,Franklin County,4154,3555,599
G4801230,Texas,DeWitt County,9176,8568,608
G1303170,Georgia,Wilkes County,5158,4548,610
G2800190,Mississippi,Choctaw County,4150,3539,611
G4802930,Texas,Limestone County,10536,9922,614
G2701130,Minnesota,Pennington County,6297,5682,615
G1301010,Georgia,Echols County,1558,942,616
G5000090,Vermont,Essex County,5019,4403,616
G5400710,West Virginia,Pendleton County,5132,4516,616
G3901610,Ohio,Van Wert County,12615,11998,617
G4000730,Oklahoma,Kingfisher County,6409,5791,618
G1900550,Iowa,Delaware County,8028,7408,620
G1600670,Idaho,Minidoka County,7665,7044,621
G2700770,Minnesota,Lake of the Woods County,3672,3050,622
G1801150,Indiana,Ohio County,2784,2161,623
G1701350,Illinois,Montgomery County,13080,12456,624
G1303070,Georgia,Webster County,1523,898,625
G2900930,Missouri,Iron County,5329,4700,629
G3800790,North Dakota,Rolette County,5372,4742,630
G1700750,Illinois,Iroquois County,13452,12819,633
G2200130,Louisiana,Bienville Parish,7718,7085,633
G2001070,Kansas,Linn County,5446,4811,635
G0500610,Arkansas,Howard County,6238,5600,638
G2100570,Kentucky,Cumberland County,3690,3051,639
G2200490,Louisiana,Jackson Parish,7680,7041,639
G5600310,Wyoming,Platte County,4667,4026,641
G1303150,Georgia,Wilcox County,3510,2865,645
G2101390,Kentucky,Livingston County,4824,4177,647
G1600350,Idaho,Clearwater County,4453,3805,648
G4000690,Oklahoma,Johnston County,5126,4478,648
G0501110,Arkansas,Poinsett County,10923,10271,652
G2800130,Mississippi,Calhoun County,6913,6260,653
G3900330,Ohio,Crawford County,20167,19514,653
G2100910,Kentucky,Hancock County,3734,3080,654
G1900430,Iowa,Clayton County,8999,8344,655
G1700230,Illinois,Clark County,7772,7115,657
G2600010,Michigan,Alcona County,11073,10414,659
G5500910,Wisconsin,Pepin County,3579,2919,660
G4701750,Tennessee,Van Buren County,2663,2001,662
G1600370,Idaho,Custer County,3103,2437,666
G1701270,Illinois,Massac County,7113,6446,667
G1801010,Indiana,Martin County,4786,4116,670
G2100230,Kentucky,Bracken County,3840,3166,674
G4000770,Oklahoma,Latimer County,4979,4303,676
G4000230,Oklahoma,Choctaw County,7521,6844,677
G2700150,Minnesota,Brown County,11493,10814,679
G2901370,Missouri,Monroe County,4798,4114,684
G2901230,Missouri,Madison County,5970,5282,688
G5400170,West Virginia,Doddridge County,3946,3251,695
G1900190,Iowa,Buchanan County,8968,8272,696
G1302390,Georgia,Quitman County,2047,1346,701
G0501270,Arkansas,Scott County,5193,4485,708
G4000350,Oklahoma,Craig County,6749,6041,708
G4900010,Utah,Beaver County,2908,2200,708
G2901210,Missouri,Macon County,7665,6955,710
G3100670,Nebraska,Gage County,10446,9735,711
G0800210,Colorado,Conejos County,4286,3574,712
G0500570,Arkansas,Hempstead County,10419,9690,729
G1301670,Georgia,Johnson County,4120,3389,731
G2100630,Kentucky,Elliott County,3371,2639,732
G4700670,Tennessee,Hancock County,3624,2890,734
G0100750,Alabama,Lamar County,7354,6617,737
G5400870,West Virginia,Roane County,7351,6611,740
G0500250,Arkansas,Cleveland County,4064,3322,742
G2101190,Kentucky,Knott County,7461,6718,743
G0800650,Colorado,Lake County,4271,3527,744
G3500330,New Mexico,Mora County,3232,2486,746
G2901630,Missouri,Pike County,7875,7128,747
G4600270,South Dakota,Clay County,5639,4892,747
G2600950,Michigan,Luce County,4343,3594,749
G4802390,Texas,Jackson County,6590,5841,749
G1901570,Iowa,Poweshiek County,8949,8199,750
G1700510,Illinois,Fayette County,9302,8551,751
G1302630,Georgia,Talbot County,3399,2645,754
G1801110,Indiana,Newton County,6030,5276,754
G5500510,Wisconsin,Iron County,5999,5243,756
G1302490,Georgia,Schley County,2208,1447,761
G4200050,Pennsylvania,Armstrong County,32520,31757,763
G4803510,Texas,Newton County,7142,6378,764
G2700290,Minnesota,Clearwater County,4773,4008,765
G0600270,California,Inyo County,9478,8712,766
G0500110,Arkansas,Bradley County,5860,5092,768
G4803130,Texas,Madison County,5096,4326,770
G1900870,Iowa,Henry County,8280,7507,773
G1801690,Indiana,Wabash County,14171,13394,777
G5400190,West Virginia,Fayette County,21618,20841,777
G4802670,Texas,Kimble County,3371,2593,778
G2600030,Michigan,Alger County,6554,5775,779
G4802730,Texas,Kleberg County,12787,12008,779
G1700410,Illinois,Douglas County,8390,7607,783
G1901230,Iowa,Mahaska County,9766,8977,789
G3500280,New Mexico,Los Alamos County,8354,7565,789
G0400110,Arizona,Greenlee County,4372,3582,790
G1701370,Illinois,Morgan County,15515,14724,791
G2101330,Kentucky,Letcher County,11601,10808,793
G4803310,Texas,Milam County,11305,10511,794
G2801570,Mississippi,Wilkinson County,5037,4242,795
G4802850,Texas,Lavaca County,10344,9549,795
G0100410,Alabama,Crenshaw County,6735,5938,797
G2400010,Maryland,Allegany County,33311,32513,798
G3901250,Ohio,Paulding County,8749,7951,798
G2901270,Missouri,Marion County,12826,12026,800
G2100870,Kentucky,Green County,5324,4523,801
G1801290,Indiana,Posey County,11207,10401,806
G2601190,Michigan,Montmorency County,9597,8791,806
G2800090,Mississippi,Benton County,4186,3379,807
G2800230,Mississippi,Clarke County,7876,7065,811
G3000610,Montana,Mineral County,2446,1635,811
G2900070,Missouri,Audrain County,10852,10039,813
G4900270,Utah,Millard County,4939,4125,814
G2100410,Kentucky,Carroll County,4696,3870,826
G2601530,Michigan,Schoolcraft County,6313,5487,826
G4701690,Tennessee,Trousdale County,3368,2537,831
G1302530,Georgia,Seminole County,4797,3962,835
G4900070,Utah,Carbon County,9551,8713,838
G1801030,Indiana,Miami County,15479,14639,840
G4700750,Tennessee,Haywood County,8315,7475,840
G1800170,Indiana,Cass County,16474,15633,841
G1600870,Idaho,Washington County,4529,3685,844
G0100630,Alabama,Greene County,5007,4162,845
G4201130,Pennsylvania,Sullivan County,6304,5458,846
G3701870,North Carolina,Washington County,6491,5644,847
G4804810,Texas,Wharton County,17127,16277,850
G2902030,Missouri,Shannon County,4164,3312,852
G1901010,Iowa,Jefferson County,7594,6739,855
G1301650,Georgia,Jenkins County,4221,3365,856
G1600030,Idaho,Adams County,2636,1778,858
G2800770,Mississippi,Lawrence County,6019,5160,859
G3100010,Nebraska,Adams County,13350,12491,859
G3900670,Ohio,Harrison County,8170,7301,869
G4803370,Texas,Montague County,10131,9262,869
G0800230,Colorado,Costilla County,2613,1743,870
G2102190,Kentucky,Todd County,5286,4415,871
G0800190,Colorado,Clear Creek County,5685,4811,874
G4801750,Texas,Goliad County,3710,2835,875
G1701390,Illinois,Moultrie County,6260,5384,876
G1302510,Georgia,Screven County,6739,5861,878
G1700810,Illinois,Jefferson County,16954,16075,879
G4001390,Oklahoma,Texas County,8208,7328,880
G2102370,Kentucky,Wolfe County,3660,2779,881
G0100570,Alabama,Fayette County,8437,7555,882
G0100350,Alabama,Conecuh County,7093,6207,886
G2101690,Kentucky,Metcalfe County,4681,3793,888
G3101310,Nebraska,Otoe County,7025,6137,888
G2901390,Missouri,Montgomery County,6130,5241,889
G4000610,Oklahoma,Haskell County,6028,5138,890
G2001110,Kansas,Lyon County,15237,14346,891
G2701610,Minnesota,Waseca County,7903,7011,892
G5400010,West Virginia,Barbour County,7849,6956,893
G3101570,Nebraska,Scotts Bluff County,16408,15514,894
G4601130,South Dakota,Shannon County,3593,2699,894
G4000490,Oklahoma,Garvin County,12827,11932,895
G1801210,Indiana,Parke County,8085,7189,896
G2901250,Missouri,Maries County,4611,3715,896
G4800430,Texas,Brewster County,5383,4486,897
G1600090,Idaho,Benewah County,4629,3731,898
G3000390,Montana,Granite County,2822,1924,898
G4700330,Tennessee,Crockett County,6425,5521,904
G2700750,Minnesota,Lake County,7681,6776,905
G3200290,Nevada,Storey County,1990,1085,905
G0500270,Arkansas,Columbia County,11596,10690,906
G5400850,West Virginia,Ritchie County,5843,4936,907
G2101870,Kentucky,Owen County,5634,4723,911
G5400890,West Virginia,Summers County,7680,6769,911
G2600110,Michigan,Arenac County,9803,8891,912
G5000130,Vermont,Grand Isle County,5048,4135,913
G1301810,Georgia,Lincoln County,4786,3870,916
G5500650,Wisconsin,Lafayette County,7230,6313,917
G1900310,Iowa,Cedar County,8064,7146,918
G4001270,Oklahoma,Pushmataha County,6110,5190,920
G1700210,Illinois,Christian County,15563,14640,923
G2600690,Michigan,Iosco County,20443,19517,926
G1700870,Illinois,Johnson County,5598,4671,927
G1302430,Georgia,Randolph County,4153,3225,928
G2801610,Mississippi,Yalobusha County,6344,5414,930
G3200170,Nevada,Lincoln County,2730,1800,930
G4803770,Texas,Presidio County,3825,2890,935
G4200570,Pennsylvania,Fulton County,7122,6184,938
G2800050,Mississippi,Amite County,6635,5695,940
G1300050,Georgia,Bacon County,4801,3859,942
G4700270,Tennessee,Clay County,4282,3340,942
G2100510,Kentucky,Clay County,8875,7930,945
G2101770,Kentucky,Muhlenberg County,13699,12754,945
G1700050,Illinois,Bond County,7089,6136,953
G1700150,Illinois,Carroll County,8437,7481,956
G2900250,Missouri,Caldwell County,4605,3649,956
G4000850,Oklahoma,Love County,4539,3583,956
G2701430,Minnesota,Sibley County,6582,5625,957
G1700110,Illinois,Bureau County,15720,14762,958
G0800810,Colorado,Moffat County,6196,5235,961
G3900690,Ohio,Henry County,11963,11000,963
G3101590,Nebraska,Seward County,6875,5908,967
G4801630,Texas,Frio County,5846,4879,967
G4804890,Texas,Willacy County,7040,6072,968
G1901270,Iowa,Marshall County,16831,15862,969
G2201190,Louisiana,Webster Parish,19336,18365,971
G2900630,Missouri,DeKalb County,4329,3358,971
G5400490,West Virginia,Marion County,26463,25491,972
G4900330,Utah,Rich County,2834,1859,975
G1600590,Idaho,Lemhi County,4729,3752,977
G5300010,Washington,Adams County,6242,5263,979
G5501070,Wisconsin,Rusk County,8883,7904,979
G1600070,Idaho,Bear Lake County,3914,2934,980
G3600970,New York,Schuyler County,9455,8472,983
G4001370,Oklahoma,Stephens County,20658,19675,983
G4801770,Texas,Gonzales County,8794,7810,984
G1900970,Iowa,Jackson County,9415,8426,989
G5600110,Wyoming,Crook County,3595,2605,990
G4804030,Texas,Sabine County,7988,6996,992
G1901910,Iowa,Winneshiek County,8721,7726,995
G2901850,Missouri,St. Clair County,5640,4645,995
G2901810,Missouri,Ripley County,6597,5597,1000
G3901110,Ohio,Monroe County,7567,6567,1000
G2100650,Kentucky,Estill County,6865,5863,1002
G2901490,Missouri,Oregon County,5486,4484,1002
G4701270,Tennessee,Moore County,2915,1912,1003
G1701290,Illinois,Menard County,5654,4650,1004
G4000990,Oklahoma,Murray County,6746,5742,1004
G4100370,Oregon,Lake County,4439,3434,1005
G5500370,Wisconsin,Florence County,4780,3775,1005
G2100710,Kentucky,Floyd County,18175,17169,1006
G2601350,Michigan,Oscoda County,9118,8112,1006
G0501330,Arkansas,Sevier County,6887,5880,1007
G3701030,North Carolina,Jones County,4838,3829,1009
G4100650,Oregon,Wasco County,11487,10476,1011
G5400910,West Virginia,Taylor County,7541,6528,1013
G1900050,Iowa,Allamakee County,7617,6603,1014
G2101610,Kentucky,Mason County,8105,7089,1016
G1900270,Iowa,Carroll County,9376,8356,1020
G0501090,Arkansas,Pike County,5580,4550,1030
G4100490,Oregon,Morrow County,4442,3412,1030
G2102290,Kentucky,Washington County,5044,4009,1035
G1300230,Georgia,Bleckley County,5304,4268,1036
G1302090,Georgia,Montgomery County,3921,2885,1036
G1800150,Indiana,Carroll County,9472,8431,1041
G1701470,Illinois,Piatt County,7269,6227,1042
G4100450,Oregon,Malheur County,11692,10649,1043
G4803410,Texas,Moore County,7881,6837,1044
G4800590,Texas,Callahan County,6549,5503,1046
G2900730,Missouri,Gasconade County,8205,7158,1047
G1800490,Indiana,Fulton County,9708,8656,1052
G3901210,Ohio,Noble County,6053,4998,1055
G2900130,Missouri,Bates County,7842,6782,1060
G1200670,Florida,Lafayette County,3328,2266,1062
G1300170,Georgia,Ben Hill County,7942,6875,1067
G1701730,Illinois,Shelby County,10396,9329,1067
G1900170,Iowa,Bremer County,9915,8847,1068
G1300030,Georgia,Atkinson County,3522,2449,1073
G1801490,Indiana,Starke County,10962,9888,1074
G5500110,Wisconsin,Buffalo County,6664,5586,1078
G3600150,New York,Chemung County,38369,37290,1079
G4200930,Pennsylvania,Montour County,7965,6885,1080
G4801650,Texas,Gaines County,6301,5221,1080
G4900370,Utah,San Juan County,5734,4650,1084
G2600430,Michigan,Dickinson County,13990,12902,1088
G1801230,Indiana,Perry County,8495,7404,1091
G0100910,Alabama,Marengo County,10237,9144,1093
G1801810,Indiana,White County,12970,11875,1095
G1800210,Indiana,Clay County,11703,10606,1097
G2701590,Minnesota,Wadena County,6899,5801,1098
G3000070,Montana,Broadwater County,2695,1593,1102
G3100470,Nebraska,Dawson County,10123,9021,1102
G4700830,Tennessee,Houston County,4188,3085,1103
G0101070,Alabama,Pickens County,9483,8379,1104
G2800150,Mississippi,Carroll County,5052,3948,1104
G1901290,Iowa,Mills County,6109,5004,1105
G2902010,Missouri,Scott County,16987,15881,1106
G2300030,Maine,Aroostook County,39529,38421,1108
G4500690,South Carolina,Marlboro County,12072,10955,1117
G2901510,Missouri,Osage County,6533,5414,1119
G4600190,South Dakota,Butte County,4621,3502,1119
G4804630,Texas,Uvalde County,10811,9692,1119
G0800470,Colorado,Gilpin County,3560,2438,1122
G2100530,Kentucky,Clinton County,5311,4189,1122
G0100050,Alabama,Barbour County,11829,10705,1124
G3900650,Ohio,Hardin County,13100,11976,1124
G4800630,Texas,Camp County,5656,4530,1126
G2801590,Mississippi,Winston County,8745,7613,1132
G2901350,Missouri,Moniteau County,6176,5043,1133
G2101970,Kentucky,Powell County,5598,4458,1140
G0601050,California,Trinity County,8681,7540,1141
G2201010,Louisiana,St. Mary Parish,23028,21884,1144
G3000010,Montana,Beaverhead County,5273,4128,1145
G3100430,Nebraska,Dakota County,7631,6486,1145
G1800250,Indiana,Crawford County,5520,4374,1146
G2100170,Kentucky,Bourbon County,8927,7781,1146
G4803950,Texas,Robertson County,8484,7338,1146
G2101530,Kentucky,Magoffin County,5950,4800,1150
G3800890,North Dakota,Stark County,10735,9585,1150
G1301090,Georgia,Evans County,4664,3512,1152
G2101350,Kentucky,Lewis County,6481,5328,1153
G0800750,Colorado,Logan County,8981,7824,1157
G1600310,Idaho,Cassia County,8372,7212,1160
G0501290,Arkansas,Searcy County,4900,3739,1161
G0800550,Colorado,Huerfano County,5075,3913,1162
G1701090,Illinois,McDonough County,14419,13257,1162
G0100470,Alabama,Dallas County,20208,19045,1163
G2000570,Kansas,Ford County,12005,10842,1163
G5300190,Washington,Ferry County,4403,3239,1164
G2900010,Missouri,Adair County,11263,10097,1166
G0100270,Alabama,Clay County,6776,5608,1168
G5300430,Washington,Lincoln County,5776,4607,1169
G5600090,Wyoming,Converse County,6403,5234,1169
G0501210,Arkansas,Randolph County,8513,7343,1170
G2900650,Missouri,Dent County,7285,6115,1170
G4804050,Texas,San Augustine County,5342,4168,1174
G2901470,Missouri,Nodaway County,9524,8349,1175
G2001390,Kansas,Osage County,7503,6324,1179
G2100310,Kentucky,Butler County,5877,4698,1179
G4800670,Texas,Cass County,14379,13191,1188
G2900390,Missouri,Cedar County,7224,6035,1189
G1800510,Indiana,Gibson County,14645,13454,1191
G4900230,Utah,Juab County,3502,2311,1191
G4200650,Pennsylvania,Jefferson County,22434,21242,1192
G2101030,Kentucky,Henry County,6640,5447,1193
G2700990,Minnesota,Mower County,17027,15831,1196
G1200770,Florida,Liberty County,3357,2157,1200
G2901530,Missouri,Ozark County,5652,4451,1201
G4000050,Oklahoma,Atoka County,6312,5110,1202
G0501050,Arkansas,Perry County,4907,3702,1205
G1900330,Iowa,Cerro Gordo County,22163,20954,1209
G4701370,Tennessee,Pickett County,3462,2253,1209
G3901150,Ohio,Morgan County,7892,6681,1211
G3600570,New York,Montgomery County,23063,21851,1212
G2000850,Kansas,Jackson County,5779,4564,1215
G0100130,Alabama,Butler County,9964,8745,1219
G4803650,Texas,Panola County,10920,9700,1220
G1800230,Indiana,Clinton County,13321,12100,1221
G0501010,Arkansas,Newton County,4664,3439,1225
G2101930,Kentucky,Perry County,12791,11565,1226
G2801110,Mississippi,Perry County,5519,4292,1227
G2701350,Minnesota,Roseau County,7469,6236,1233
G1801470,Indiana,Spencer County,8872,7636,1236
G1801550,Indiana,Switzerland County,4969,3732,1237
G4500610,South Carolina,Lee County,7775,6537,1238
G4900170,Utah,Garfield County,3726,2488,1238
G0800710,Colorado,Las Animas County,8217,6975,1242
G4700610,Tennessee,Grundy County,6397,5155,1242
G2101150,Kentucky,Johnson County,10624,9381,1243
G3000930,Montana,Silver Bow County,16717,15474,1243
G4804250,Texas,Somervell County,3674,2429,1245
G0500430,Arkansas,Drew County,8408,7159,1249
G1300490,Georgia,Charlton County,4475,3222,1253
G1900950,Iowa,Iowa County,7258,6003,1255
G4804190,Texas,Shelby County,11873,10616,1257
G2800410,Mississippi,Greene County,5123,3864,1259
G3500410,New Mexico,Roosevelt County,8163,6902,1261
G2102130,Kentucky,Simpson County,7435,6172,1263
G4802250,Texas,Houston County,11532,10265,1267
G2101750,Kentucky,Morgan County,5830,4562,1268
G3901750,Ohio,Wyandot County,9870,8596,1274
G2000370,Kansas,Crawford County,17801,16526,1275
G1301890,Georgia,McDuffie County,9319,8043,1276
G2801010,Mississippi,Newton County,9373,8095,1278
G1700730,Illinois,Henry County,22161,20881,1280
G0100650,Alabama,Hale County,7655,6370,1285
G5500030,Wisconsin,Ashland County,9656,8371,1285
G1301930,Georgia,Macon County,6136,4848,1288
G1600410,Idaho,Franklin County,4528,3240,1288
G1800130,Indiana,Brown County,8285,6997,1288
G1600470,Idaho,Gooding County,6093,4800,1293
G0800030,Colorado,Alamosa County,6554,5254,1300
G4701310,Tennessee,Obion County,14659,13359,1300
G4100010,Oregon,Baker County,8826,7525,1301
G4500090,South Carolina,Bamberg County,7716,6408,1308
G2200910,Louisiana,St. Helena Parish,5150,3840,1310
G2902170,Missouri,Vernon County,9495,8181,1314
G2902070,Missouri,Stoddard County,13609,12288,1321
G2101650,Kentucky,Menifee County,3744,2421,1323
G4201230,Pennsylvania,Warren County,23560,22236,1324
G4900290,Utah,Morgan County,3006,1681,1325
G2101430,Kentucky,Lyon County,4791,3460,1331
G2900170,Missouri,Bollinger County,5878,4542,1336
G2600610,Michigan,Houghton County,18636,17296,1340
G2200850,Louisiana,Sabine Parish,14130,12789,1341
G2200530,Louisiana,Jefferson Davis Parish,13306,11963,1343
G2700550,Minnesota,Houston County,8601,7257,1344
G2101230,Kentucky,Larue County,6172,4824,1348
G2200390,Louisiana,Evangeline Parish,14662,13311,1351
G0801050,Colorado,Rio Grande County,6630,5277,1353
G2900850,Missouri,Hickory County,6835,5482,1353
G2200470,Louisiana,Iberville Parish,12707,11352,1355
G3900530,Ohio,Gallia County,13925,12564,1361
G4600350,South Dakota,Davison County,8852,7490,1362
G0100370,Alabama,Coosa County,6478,5113,1365
G4200510,Pennsylvania,Fayette County,62773,61406,1367
G4600650,South Dakota,Hughes County,7623,6255,1368
G2200310,Louisiana,De Soto Parish,12290,10919,1371
G2901770,Missouri,Ray County,9984,8611,1373
G4701350,Tennessee,Perry County,4599,3225,1374
G2700450,Minnesota,Fillmore County,9732,8356,1376
G4800490,Texas,Brown County,18287,16909,1378
G3700410,North Carolina,Chowan County,7289,5910,1379
G2100110,Kentucky,Bath County,5405,4021,1384
G1900150,Iowa,Boone County,11756,10371,1385
G2801290,Mississippi,Smith County,7237,5850,1387
G2200430,Louisiana,Grant Parish,8886,7494,1392
G3901050,Ohio,Meigs County,11191,9795,1396
G4201310,Pennsylvania,Wyoming County,13254,11857,1397
G1302690,Georgia,Taylor County,4563,3162,1401
G4700170,Tennessee,Carroll County,13184,11783,1401
G3500060,New Mexico,Cibola County,11101,9692,1409
G2900670,Missouri,Douglas County,6519,5105,1414
G5500470,Wisconsin,Green Lake County,10616,9202,1414
G2901730,Missouri,Ralls County,5183,3766,1417
G2102230,Kentucky,Trimble County,3930,2510,1420
G2700830,Minnesota,Lyon County,11098,9675,1423
G2200770,Louisiana,Pointe Coupee Parish,11130,9695,1435
G3901630,Ohio,Vinton County,6291,4856,1435
G2100450,Kentucky,Casey County,7487,6046,1441
G5600190,Wyoming,Johnson County,4553,3112,1441
G2800250,Mississippi,Clay County,9180,7737,1443
G2800430,Mississippi,Grenada County,10155,8712,1443
G5400330,West Virginia,Harrison County,31431,29988,1443
G1801170,Indiana,Orange County,9176,7732,1444
G2600630,Michigan,Huron County,21199,19755,1444
G5400930,West Virginia,Tucker County,5346,3900,1446
G0600210,California,Glenn County,10778,9329,1449
G1600730,Idaho,Owyhee County,4781,3332,1449
G2800070,Mississippi,Attala County,9126,7674,1452
G1800650,Indiana,Henry County,21288,19835,1453
G4801610,Texas,Freestone County,9265,7812,1453
G2100610,Kentucky,Edmonson County,6467,5009,1458
G2200030,Louisiana,Allen Parish,9733,8275,1458
G5400430,West Virginia,Lincoln County,9887,8429,1458
G2100690,Kentucky,Fleming County,6623,5163,1460
G4001110,Oklahoma,Okmulgee County,17891,16431,1460
G2900530,Missouri,Cooper County,7463,6002,1461
G2900030,Missouri,Andrew County,7306,5841,1465
G5600410,Wyoming,Uinta County,8713,7246,1467
G2101470,Kentucky,McCreary County,7507,6039,1468
G3701370,North Carolina,Pamlico County,7534,6050,1484
G0100290,Alabama,Cleburne County,6718,5232,1486
G1800270,Indiana,Daviess County,12471,10985,1486
G2902290,Missouri,Wright County,8700,7214,1486
G5500230,Wisconsin,Crawford County,8802,7315,1487
G2801470,Mississippi,Walthall County,7132,5643,1489
G2801530,Mississippi,Wayne County,9213,7723,1490
G3700150,North Carolina,Bertie County,9822,8331,1491
G0500970,Arkansas,Montgomery County,5763,4269,1494
G1302930,Georgia,Upson County,12161,10667,1494
G2100770,Kentucky,Gallatin County,3786,2290,1496
G4001230,Oklahoma,Pontotoc County,16595,15094,1501
G2601410,Michigan,Presque Isle County,10428,8917,1511
G2800610,Mississippi,Jasper County,8212,6700,1512
G3000950,Montana,Stillwater County,4803,3291,1512
G3700730,North Carolina,Gates County,5208,3696,1512
G4804550,Texas,Trinity County,8713,7200,1513
G4100610,Oregon,Union County,11489,9974,1515
G1701170,Illinois,Macoupin County,21584,20068,1516
G2200930,Louisiana,St. James Parish,8455,6934,1521
G2700310,Minnesota,Cook County,5839,4312,1527
G4700390,Tennessee,Decatur County,6873,5346,1527
G4701010,Tennessee,Lewis County,5470,3943,1527
G1701050,Illinois,Livingston County,15895,14365,1530
G1200130,Florida,Calhoun County,5999,4468,1531
G4804570,Texas,Tyler County,10579,9047,1532
G1201250,Florida,Union County,4508,2975,1533
G2700930,Minnesota,Meeker County,10674,9139,1535
G5500670,Wisconsin,Langlade County,12360,10825,1535
G1300330,Georgia,Burke County,9865,8329,1536
G0801090,Colorado,Saguache County,3843,2306,1537
G2200370,Louisiana,East Feliciana Parish,8014,6476,1538
G2101830,Kentucky,Ohio County,10219,8680,1539
G5501030,Wisconsin,Richland County,8868,7325,1543
G2101950,Kentucky,Pike County,30304,28760,1544
G1901050,Iowa,Jones County,8911,7366,1545
G4701810,Tennessee,Wayne County,7287,5741,1546
G1301990,Georgia,Meriwether County,9957,8409,1548
G4800350,Texas,Bosque County,9623,8074,1549
G4801590,Texas,Franklin County,5770,4219,1551
G1302050,Georgia,Mitchell County,8996,7443,1553
G2101910,Kentucky,Pendleton County,6339,4782,1557
G1300430,Georgia,Candler County,4761,3203,1558
G1901210,Iowa,Madison County,6554,4995,1559
G0500830,Arkansas,Logan County,10108,8539,1569
G2900830,Missouri,Henry County,10886,9317,1569
G0800910,Colorado,Ouray County,3083,1507,1576
G0500190,Arkansas,Clark County,10385,8807,1578
G2000550,Kansas,Finney County,13276,11696,1580
G3900310,Ohio,Coshocton County,16545,14964,1581
G3500250,New Mexico,Lea County,24919,23333,1586
G0600110,California,Colusa County,7883,6295,1588
G5400970,West Virginia,Upshur County,11099,9506,1593
G4201050,Pennsylvania,Potter County,12932,11334,1598
G3701170,North Carolina,Martin County,11704,10104,1600
G2101270,Kentucky,Lawrence County,7286,5684,1602
G4600130,South Dakota,Brown County,16706,15101,1605
G5400630,West Virginia,Monroe County,7601,5994,1607
G1301490,Georgia,Heard County,5148,3536,1612
G3000090,Montana,Carbon County,6441,4828,1613
G5400230,West Virginia,Grant County,6366,4746,1620
G2600070,Michigan,Alpena County,16053,14431,1622
G1301070,Georgia,Emanuel County,9968,8344,1624
G4700870,Tennessee,Jackson County,5843,4219,1624
G4600330,South Dakota,Custer County,4628,3003,1625
G3101550,Nebraska,Saunders County,9221,7594,1627
G2101090,Kentucky,Jackson County,6523,4895,1628
G1303030,Georgia,Washington County,9047,7416,1631
G1700830,Illinois,Jersey County,9848,8216,1632
G3700290,North Carolina,Camden County,4104,2466,1638
G2600570,Michigan,Gratiot County,16339,14699,1640
G5400830,West Virginia,Randolph County,14189,12548,1641
G3901470,Ohio,Seneca County,24122,22473,1649
G1901830,Iowa,Washington County,9516,7866,1650
G1303210,Georgia,Worth County,9251,7597,1654
G1801770,Indiana,Wayne County,31242,29586,1656
G1200470,Florida,Hamilton County,5778,4119,1659
G3101410,Nebraska,Platte County,13378,11716,1662
G2001550,Kansas,Reno County,28274,26607,1667
G4700150,Tennessee,Cannon County,6037,4368,1669
G2100890,Kentucky,Greenup County,16330,14657,1673
G2902230,Missouri,Wayne County,8083,6406,1677
G4700690,Tennessee,Hardeman County,10851,9174,1677
G1302350,Georgia,Pulaski County,5151,3470,1681
G2701530,Minnesota,Todd County,12917,11234,1683
G5400550,West Virginia,Mercer County,30115,28426,1689
G1301050,Georgia,Elbert County,9583,7891,1692
G1301610,Georgia,Jeff Davis County,6488,4792,1696
G0500650,Arkansas,Izard County,7232,5535,1697
G1302990,Georgia,Ware County,16326,14628,1698
G0100990,Alabama,Monroe County,11333,9633,1700
G2901570,Missouri,Perry County,8568,6867,1701
G4100270,Oregon,Hood River County,9271,7569,1702
G1701770,Illinois,Stephenson County,22081,20378,1703
G2201250,Louisiana,West Feliciana Parish,5097,3392,1705
G4000890,Oklahoma,McCurtain County,15533,13828,1705
G2800910,Mississippi,Marion County,11838,10132,1706
G5300590,Washington,Skamania County,5628,3922,1706
G2200070,Louisiana,Assumption Parish,10351,8644,1707
G5400070,West Virginia,Braxton County,7415,5708,1707
G0500290,Arkansas,Conway County,9720,8009,1711
G2601090,Michigan,Menominee County,14227,12509,1718
G2100970,Kentucky,Harrison County,8208,6488,1720
G4802870,Texas,Lee County,7499,5773,1726
G2101670,Kentucky,Mercer County,9941,8212,1729
G3600990,New York,Seneca County,16043,14314,1729
G4700850,Tennessee,Humphreys County,8865,7136,1729
G3701210,North Carolina,Mitchell County,8713,6983,1730
G1801790,Indiana,Wells County,11659,9928,1731
G1300270,Georgia,Brooks County,7706,5972,1734
G3901450,Ohio,Scioto County,34142,32408,1734
G1701030,Illinois,Lee County,15049,13314,1735
G4803790,Texas,Rains County,5269,3533,1736
G2400390,Maryland,Somerset County,11130,9393,1737
G3500030,New Mexico,Catron County,3289,1552,1737
G0800270,Colorado,Custer County,3956,2216,1740
G1901490,Iowa,Plymouth County,10550,8806,1744
G4001470,Oklahoma,Washington County,23451,21707,1744
G2102030,Kentucky,Rockcastle County,7703,5958,1745
G2700650,Minnesota,Kanabec County,7849,6098,1751
G3000430,Montana,Jefferson County,5055,3302,1753
G4701710,Tennessee,Unicoi County,8830,7076,1754
G2600970,Michigan,Mackinac County,11010,9254,1756
G2000510,Kansas,Ellis County,12872,11115,1757
G3500070,New Mexico,Colfax County,10023,8265,1758
G5500610,Wisconsin,Kewaunee County,9304,7544,1760
G3700910,North Carolina,Hertford County,10635,8870,1765
G2102350,Kentucky,Whitley County,15166,13399,1767
G5500410,Wisconsin,Forest County,8970,7203,1767
G1701950,Illinois,Whiteside County,25770,24000,1770
G3500530,New Mexico,Socorro County,8059,6289,1770
G2001130,Kansas,McPherson County,12721,10941,1780
G1200490,Florida,Hardee County,9722,7941,1781
G0101290,Alabama,Washington County,8407,6625,1782
G0100250,Alabama,Clarke County,12638,10853,1785
G4800510,Texas,Burleson County,8832,7044,1788
G2701570,Minnesota,Wabasha County,9997,8205,1792
G0500470,Arkansas,Franklin County,8021,6228,1793
G3700750,North Carolina,Graham County,5930,4132,1798
G2800790,Mississippi,Leake County,9415,7614,1801
G1801670,Indiana,Vigo County,46006,44203,1803
G2801430,Mississippi,Tunica County,4803,2990,1813
G1700010,Illinois,Adams County,29842,28021,1821
G4900190,Utah,Grand County,4816,2992,1824
G5400670,West Virginia,Nicholas County,13064,11235,1829
G0100670,Alabama,Henry County,8891,7056,1835
G1300550,Georgia,Chattooga County,10977,9142,1835
G2801410,Mississippi,Tishomingo County,10295,8455,1840
G1900990,Iowa,Jasper County,16181,14338,1843
G2000870,Kansas,Jefferson County,8160,6314,1846
G2801390,Mississippi,Tippah County,9696,7846,1850
G4800570,Texas,Calhoun County,11410,9559,1851
G2101070,Kentucky,Hopkins County,21180,19325,1855
G1200590,Florida,Holmes County,8641,6785,1856
G5500770,Wisconsin,Marquette County,9896,8035,1861
G3601230,New York,Yates County,13491,11629,1862
G4803630,Texas,Palo Pinto County,15214,13349,1865
G1901390,Iowa,Muscatine County,17910,16044,1866
G4700050,Tennessee,Benton County,8975,7107,1868
G2901860,Missouri,Ste. Genevieve County,8637,6766,1871
G1800550,Indiana,Greene County,15211,13337,1874
G4200070,Pennsylvania,Beaver County,78211,76336,1875
G1800870,Indiana,LaGrange County,14094,12218,1876
G3900130,Ohio,Belmont County,32452,30575,1877
G3900470,Ohio,Fayette County,12693,10816,1877
G1300010,Georgia,Appling County,8512,6629,1883
G0501490,Arkansas,Yell County,9752,7868,1884
G3600230,New York,Cortland County,20577,18681,1896
G4200870,Pennsylvania,Mifflin County,21537,19641,1896
G2901070,Missouri,Lafayette County,14718,12820,1898
G2801170,Mississippi,Prentiss County,11054,9155,1899
G3500510,New Mexico,Sierra County,8356,6457,1899
G4700970,Tennessee,Lauderdale County,11256,9343,1913
G3101770,Nebraska,Washington County,8301,6378,1923
G3901710,Ohio,Williams County,16668,14745,1923
G4500870,South Carolina,Union County,14153,12230,1923
G2800290,Mississippi,Copiah County,12184,10260,1924
G4200130,Pennsylvania,Blair County,56276,54349,1927
G3600490,New York,Lewis County,15112,13182,1930
G3900590,Ohio,Guernsey County,19193,17262,1931
G1600210,Idaho,Boundary County,5175,3242,1933
G0500490,Arkansas,Fulton County,6778,4839,1939
G4701210,Tennessee,Meigs County,5628,3689,1939
G4200310,Pennsylvania,Clarion County,19962,18022,1940
G3101190,Nebraska,Madison County,15014,13069,1945
G1901670,Iowa,Sioux County,12279,10333,1946
G1300750,Georgia,Cook County,7287,5340,1947
G4000190,Oklahoma,Carter County,21148,19201,1947
G4700070,Tennessee,Bledsoe County,5718,3771,1947
G3601070,New York,Tioga County,22203,20254,1949
G2800310,Mississippi,Covington County,8496,6535,1961
G1301410,Georgia,Hancock County,5360,3396,1964
G1900110,Iowa,Benton County,11095,9125,1970
G4805050,Texas,Zapata County,6203,4225,1978
G2801230,Mississippi,Scott County,11470,9488,1982
G3100530,Nebraska,Dodge County,16584,14601,1983
G4800890,Texas,Colorado County,10527,8537,1990
G3900390,Ohio,Defiance County,16729,14737,1992
G4601270,South Dakota,Union County,6280,4286,1994
G1301970,Georgia,Marion County,4156,2152,2004
G1300870,Georgia,Decatur County,12125,10120,2005
G2601130,Michigan,Missaukee County,9117,7112,2005
G2800570,Mississippi,Itawamba County,10126,8116,2010
G1300790,Georgia,Crawford County,5292,3279,2013
G3701430,North Carolina,Perquimans County,6986,4972,2014
G4000010,Oklahoma,Adair County,9142,7124,2018
G2201210,Louisiana,West Baton Rouge Parish,9324,7298,2026
G4001010,Oklahoma,Muskogee County,30908,28882,2026
G2101410,Kentucky,Logan County,12339,10303,2036
G4700230,Tennessee,Chester County,6980,4944,2036
G2201110,Louisiana,Union Parish,11346,9304,2042
G1301730,Georgia,Lanier County,4249,2202,2047
G2100990,Kentucky,Hart County,8559,6501,2058
G2102170,Kentucky,Taylor County,10864,8798,2066
G2101550,Kentucky,Marion County,8182,6115,2067
G3400330,New Jersey,Salem County,27417,25349,2068
G5500990,Wisconsin,Price County,11120,9052,2068
G2601290,Michigan,Ogemaw County,16047,13977,2070
G5400530,West Virginia,Mason County,13006,10932,2074
G3200130,Nevada,Humboldt County,7123,5044,2079
G1801190,Indiana,Owen County,10091,8011,2080
G4601350,South Dakota,Yankton County,9652,7571,2081
G5500070,Wisconsin,Bayfield County,12999,10918,2081
G4500490,South Carolina,Hampton County,9140,7058,2082
G1800010,Indiana,Adams County,13014,10931,2083
G3600730,New York,Orleans County,18431,16345,2086
G0100170,Alabama,Chambers County,17004,14910,2094
G4500890,South Carolina,Williamsburg County,15359,13265,2094
G0600150,California,Del Norte County,11186,9091,2095
G4804010,Texas,Rusk County,21191,19092,2099
G5500530,Wisconsin,Jackson County,9727,7627,2100
G4500650,South Carolina,McCormick County,5453,3347,2106
G5400570,West Virginia,Mineral County,13039,10930,2109
G1800310,Indiana,Decatur County,11209,9098,2111
G4500170,South Carolina,Calhoun County,7340,5225,2115
G2100210,Kentucky,Boyle County,12312,10191,2121
G3601210,New York,Wyoming County,17970,15848,2122
G0100530,Alabama,Escambia County,16486,14356,2130
G3901370,Ohio,Putnam County,13731,11600,2131
G4200730,Pennsylvania,Lawrence County,40975,38844,2131
G2100010,Kentucky,Adair County,8568,6434,2134
G3900790,Ohio,Jackson County,14587,12452,2135
G0100930,Alabama,Marion County,14737,12597,2140
G2300210,Maine,Piscataquis County,15340,13194,2146
G2001490,Kansas,Pottawatomie County,8626,6472,2154
G2902150,Missouri,Texas County,11685,9525,2160
G3900190,Ohio,Carroll County,13698,11536,2162
G0501370,Arkansas,Stone County,6712,4548,2164
G3100250,Nebraska,Cass County,11117,8951,2166
G2800950,Mississippi,Monroe County,16455,14285,2170
G5500190,Wisconsin,Clark County,15076,12904,2172
G1800690,Indiana,Huntington County,15805,13629,2176
G2700390,Minnesota,Dodge County,7947,5771,2176
G4500670,South Carolina,Marion County,14953,12777,2176
G2900590,Missouri,Dallas County,7662,5484,2178
G1302610,Georgia,Sumter County,13909,11726,2183
G2601330,Michigan,Osceola County,13632,11444,2188
G1302790,Georgia,Toombs County,12144,9952,2192
G4701090,Tennessee,McNairy County,11933,9734,2199
G4802490,Texas,Jim Wells County,16147,13948,2199
G0501350,Arkansas,Sharp County,9822,7617,2205
G1200790,Florida,Madison County,8481,6275,2206
G1600530,Idaho,Jerome County,8101,5886,2215
G5500310,Wisconsin,Douglas County,22825,20610,2215
G4200090,Pennsylvania,Bedford County,23954,21738,2216
G0500530,Arkansas,Grant County,7758,5540,2218
G2000590,Kansas,Franklin County,11147,8926,2221
G5400250,West Virginia,Greenbrier County,18980,16757,2223
G4500010,South Carolina,Abbeville County,12079,9846,2233
G5400990,West Virginia,Wayne County,19227,16991,2236
G1200650,Florida,Jefferson County,6632,4395,2237
G2000790,Kansas,Harvey County,14527,12290,2237
G3900030,Ohio,Allen County,44999,42758,2241
G2100830,Kentucky,Graves County,16777,14528,2249
G0100590,Alabama,Franklin County,14022,11772,2250
G3800350,North Dakota,Grand Forks County,29344,27085,2259
G0800870,Colorado,Morgan County,11490,9230,2260
G3700790,North Carolina,Greene County,8213,5944,2269
G0501130,Arkansas,Polk County,10002,7732,2270
G0100610,Alabama,Geneva County,12687,10416,2271
G4400010,Rhode Island,Bristol County,20850,18567,2283
G2400190,Maryland,Dorchester County,16554,14269,2285
G2600410,Michigan,Delta County,20214,17928,2286
G0500870,Arkansas,Madison County,7481,5182,2299
G3600350,New York,Fulton County,28562,26260,2302
G1300830,Georgia,Dade County,7305,4998,2307
G2900490,Missouri,Clinton County,8876,6559,2317
G4700450,Tennessee,Dyer County,16703,14384,2319
G3700070,North Carolina,Anson County,11576,9255,2321
G1300930,Georgia,Dooly County,6328,4003,2325
G4701390,Tennessee,Polk County,7991,5659,2332
G3000890,Montana,Sanders County,6678,4335,2343
G0600350,California,Lassen County,12710,10358,2352
G4802230,Texas,Hopkins County,15029,12676,2353
G5300030,Washington,Asotin County,9872,7519,2353
G1200430,Florida,Glades County,6979,4624,2355
G1800470,Indiana,Franklin County,9538,7176,2362
G1801430,Indiana,Scott County,10440,8078,2362
G2601010,Michigan,Manistee County,15694,13330,2364
G4700530,Tennessee,Gibson County,21999,19635,2364
G1801370,Indiana,Ripley County,11952,9587,2365
G2600390,Michigan,Crawford County,11092,8727,2365
G3700330,North Carolina,Caswell County,10619,8254,2365
G2400290,Maryland,Kent County,10549,8181,2368
G2100270,Kentucky,Breckinridge County,10630,8261,2369
G3101110,Nebraska,Lincoln County,16583,14210,2373
G1600450,Idaho,Gem County,7099,4725,2374
G2200110,Louisiana,Beauregard Parish,15040,12666,2374
G1700490,Illinois,Effingham County,14570,12189,2381
G2801490,Mississippi,Warren County,21896,19512,2384
G2101010,Kentucky,Henderson County,20320,17932,2388
G0101270,Alabama,Walker County,30816,28427,2389
G1800770,Indiana,Jefferson County,14311,11921,2390
G4900410,Utah,Sevier County,8449,6059,2390
G2600230,Michigan,Branch County,20841,18449,2392
G3900370,Ohio,Darke County,22730,20338,2392
G4701610,Tennessee,Stewart County,6778,4384,2394
G4800310,Texas,Blanco County,5532,3135,2397
G1600150,Idaho,Boise County,5292,2894,2398
G1600490,Idaho,Idaho County,8744,6346,2398
G4201090,Pennsylvania,Snyder County,16027,13629,2398
G4201110,Pennsylvania,Somerset County,38113,35713,2400
G1301710,Georgia,Lamar County,7474,5066,2408
G1302570,Georgia,Stephens County,12662,10254,2408
G4500230,South Carolina,Chester County,14701,12293,2408
G1901930,Iowa,Woodbury County,41484,39071,2413
G1300810,Georgia,Crisp County,10734,8318,2416
G2801450,Mississippi,Union County,11520,9104,2416
G5000030,Vermont,Bennington County,20922,18501,2421
G1600750,Idaho,Payette County,8945,6520,2425
G1701610,Illinois,Rock Island County,65756,63327,2429
G3701650,North Carolina,Scotland County,15193,12759,2434
G3000670,Montana,Park County,9375,6926,2449
G3500150,New Mexico,Eddy County,22585,20134,2451
G4200670,Pennsylvania,Juniata County,10978,8505,2473
G4701590,Tennessee,Smith County,8529,6049,2480
G0600430,California,Mariposa County,10188,7700,2488
G4802890,Texas,Leon County,9509,7019,2490
G5000050,Vermont,Caledonia County,15942,13449,2493
G1901250,Iowa,Marion County,13914,11420,2494
G4500810,South Carolina,Saluda County,9289,6792,2497
G5500490,Wisconsin,Iowa County,10719,8220,2499
G5400310,West Virginia,Hardy County,8078,5573,2505
G5000170,Vermont,Orange County,14845,12336,2509
G1301590,Georgia,Jasper County,6153,3637,2516
G3701530,North Carolina,Richmond County,20738,18218,2520
G5501210,Wisconsin,Trempealeau County,12619,10097,2522
G4802810,Texas,Lampasas County,8718,6193,2525
G2102210,Kentucky,Trigg County,7810,5284,2526
G5300510,Washington,Pend Oreille County,7936,5404,2532
G2100790,Kentucky,Garrard County,7463,4929,2534
G1302710,Georgia,Telfair County,7297,4756,2541
G4701290,Tennessee,Morgan County,8920,6378,2542
G3600170,New York,Chenango County,24710,22164,2546
G1302210,Georgia,Oglethorpe County,6484,3936,2548
G2801270,Mississippi,Simpson County,11934,9374,2560
G1700270,Illinois,Clinton County,15311,12746,2565
G2000610,Kansas,Geary County,14517,11952,2565
G1600430,Idaho,Fremont County,8531,5961,2570
G5300390,Washington,Klickitat County,9786,7213,2573
G5400110,West Virginia,Cabell County,46169,43596,2573
G0100070,Alabama,Bibb County,8981,6404,2577
G1801070,Indiana,Montgomery County,16535,13957,2578
G4900250,Utah,Kane County,5815,3237,2578
G3600430,New York,Herkimer County,33381,30799,2582
G2800990,Mississippi,Neshoba County,12357,9770,2587
G5000210,Vermont,Rutland County,33768,31181,2587
G3600070,New York,Broome County,90563,87969,2594
G5401070,West Virginia,Wood County,40215,37620,2595
G5501370,Wisconsin,Waushara County,14843,12246,2597
G2901190,Missouri,McDonald County,9925,7327,2598
G4200350,Pennsylvania,Clinton County,19080,16478,2602
G3300070,New Hampshire,Coos County,21321,18712,2609
G3800590,North Dakota,Morton County,12079,9467,2612
G0500350,Arkansas,Crittenden County,21489,18875,2614
G2200090,Louisiana,Avoyelles Parish,18042,15428,2614
G3901670,Ohio,Washington County,28367,25752,2615
G4000950,Oklahoma,Marshall County,10006,7389,2617
G2102070,Kentucky,Russell County,9993,7375,2618
G4500110,South Carolina,Barnwell County,10484,7854,2630
G1301310,Georgia,Grady County,10760,8129,2631
G2700790,Minnesota,Le Sueur County,12416,9785,2631
G3901430,Ohio,Sandusky County,26390,23753,2637
G4701830,Tennessee,Weakley County,15495,12857,2638
G4000910,Oklahoma,McIntosh County,13350,10708,2642
G0100390,Alabama,Covington County,18829,16178,2651
G5400810,West Virginia,Raleigh County,35931,33278,2653
G1302110,Georgia,Morgan County,7472,4814,2658
G4201150,Pennsylvania,Susquehanna County,22968,20308,2660
G3901070,Ohio,Mercer County,17633,14969,2664
G2800390,Mississippi,George County,9330,6663,2667
G3900110,Ohio,Auglaize County,19585,16907,2678
G2900230,Missouri,Butler County,19731,17046,2685
G3901010,Ohio,Marion County,27834,25149,2685
G4801470,Texas,Fannin County,14191,11504,2687
G4804490,Texas,Titus County,12054,9357,2697
G1801750,Indiana,Washington County,12220,9520,2700
G3701310,North Carolina,Northampton County,11674,8974,2700
G4700410,Tennessee,DeKalb County,9405,6694,2711
G3901350,Ohio,Preble County,17888,15174,2714
G1302290,Georgia,Pierce County,7986,5271,2715
G3900210,Ohio,Champaign County,16755,14030,2725
G2102050,Kentucky,Rowan County,10102,7375,2727
G4100150,Oregon,Curry County,12613,9885,2728
G5400350,West Virginia,Jackson County,13305,10571,2734
G2400110,Maryland,Caroline County,13482,10745,2737
G5000010,Vermont,Addison County,16760,14022,2738
G3900010,Ohio,Adams County,12978,10237,2741
G3700050,North Carolina,Alleghany County,8094,5344,2750
G2101210,Kentucky,Knox County,14485,11731,2754
G3901310,Ohio,Pike County,12481,9722,2759
G1200370,Florida,Franklin County,8652,5891,2761
G1300910,Georgia,Dodge County,9857,7094,2763
G0501410,Arkansas,Van Buren County,10345,7580,2765
G1200450,Florida,Gulf County,9110,6339,2771
G2900210,Missouri,Buchanan County,38427,35652,2775
G5600330,Wyoming,Sheridan County,13939,11154,2785
G2600510,Michigan,Gladwin County,17672,14885,2787
G4701510,Tennessee,Scott County,9910,7122,2788
G4701530,Tennessee,Sequatchie County,6368,3570,2798
G3600950,New York,Schoharie County,17231,14431,2800
G2901590,Missouri,Pettis County,18249,15443,2806
G2700670,Minnesota,Kandiyohi County,19476,16669,2807
G3300190,New Hampshire,Sullivan County,22341,19532,2809
G3900870,Ohio,Lawrence County,27603,24788,2815
G1700850,Illinois,Jo Daviess County,13574,10757,2817
G2101370,Kentucky,Lincoln County,10819,7985,2834
G4700490,Tennessee,Fentress County,8961,6120,2841
G1300190,Georgia,Berrien County,8709,5858,2851
G2600850,Michigan,Lake County,14966,12114,2852
G2101630,Kentucky,Meade County,11762,8907,2855
G4600290,South Dakota,Codington County,12397,9539,2858
G5600350,Wyoming,Sublette County,5770,2911,2859
G2801130,Mississippi,Pike County,17861,14995,2866
G4201070,Pennsylvania,Schuylkill County,69323,66457,2866
G4700910,Tennessee,Johnson County,8956,6090,2866
G5501190,Wisconsin,Taylor County,10582,7710,2872
G1200290,Florida,Dixie County,9319,6445,2874
G2901410,Missouri,Morgan County,15517,12642,2875
G5501230,Wisconsin,Vernon County,13720,10830,2890
G4000810,Oklahoma,Lincoln County,15208,12302,2906
G4701330,Tennessee,Overton County,10295,7388,2907
G2701030,Minnesota,Nicollet County,12873,9963,2910
G1200070,Florida,Bradford County,11011,8099,2912
G3500570,New Mexico,Torrance County,7798,4878,2920
G4200810,Pennsylvania,Lycoming County,52500,49580,2920
G4200150,Pennsylvania,Bradford County,29979,27058,2921
G2900550,Missouri,Crawford County,11955,9030,2925
G2100030,Kentucky,Allen County,9307,6381,2926
G3600650,New York,Oneida County,104180,101251,2929
G3900730,Ohio,Hocking County,13417,10481,2936
G1301190,Georgia,Franklin County,10553,7613,2940
G1800790,Indiana,Jennings County,12069,9129,2940
G3701150,North Carolina,Madison County,10608,7667,2941
G2902210,Missouri,Washington County,11017,8075,2942
G4701150,Tennessee,Marion County,12954,10011,2943
G4001130,Oklahoma,Osage County,21143,18196,2947
G5501130,Wisconsin,Sawyer County,15975,13025,2950
G3901270,Ohio,Perry County,15211,12260,2951
G4500390,South Carolina,Fairfield County,11681,8730,2951
G0500590,Arkansas,Hot Spring County,14332,11378,2954
G5400770,West Virginia,Preston County,15097,12137,2960
G2001690,Kansas,Saline County,24101,21129,2972
G4802410,Texas,Jasper County,16798,13824,2974
G1600690,Idaho,Nez Perce County,17438,14463,2975
G3700430,North Carolina,Clay County,7140,4158,2982
G4701110,Tennessee,Macon County,9861,6879,2982
G2901310,Missouri,Miller County,12758,9766,2992
G3600370,New York,Genesee County,25589,22596,2993
G5400650,West Virginia,Morgan County,9753,6757,2996
G3700650,North Carolina,Edgecombe County,24838,21827,3011
G2801310,Mississippi,Stone County,7161,4148,3013
G4803490,Texas,Navarro County,20234,17219,3015
G4700550,Tennessee,Giles County,13844,10828,3016
G0100790,Alabama,Lawrence County,15229,12212,3017
G2600790,Michigan,Kalkaska County,12171,9151,3020
G2100430,Kentucky,Carter County,12311,9290,3021
G2102390,Kentucky,Woodford County,10711,7689,3022
G1302310,Georgia,Pike County,6820,3797,3023
G1800990,Indiana,Marshall County,19845,16820,3025
G3000570,Montana,Madison County,6940,3902,3038
G3701990,North Carolina,Yancey County,11032,7994,3038
G1700770,Illinois,Jackson County,28578,25539,3039
G3900230,Ohio,Clark County,61419,58377,3042
G4200850,Pennsylvania,Mercer County,51733,48689,3044
G3900290,Ohio,Columbiana County,47088,44035,3053
G3701730,North Carolina,Swain County,8723,5664,3059
G1302770,Georgia,Tift County,16434,13359,3075
G4200610,Pennsylvania,Huntingdon County,22365,19286,3079
G2601270,Michigan,Oceana County,15944,12857,3087
G3701850,North Carolina,Warren County,11806,8714,3092
G1201330,Florida,Washington County,10796,7703,3093
G2700010,Minnesota,Aitkin County,16029,12934,3095
G1201230,Florida,Taylor County,11004,7908,3096
G1700290,Illinois,Coles County,23425,20329,3096
G5000150,Vermont,Lamoille County,12969,9872,3097
G0500910,Arkansas,Miller County,19281,16172,3109
G4801490,Texas,Fayette County,13868,10756,3112
G2100850,Kentucky,Grayson County,13561,10446,3115
G0800970,Colorado,Pitkin County,12953,9837,3116
G2800850,Mississippi,Lincoln County,15255,12133,3122
G1900590,Iowa,Dickinson County,12849,9723,3126
G2701690,Minnesota,Winona County,20760,17630,3130
G5500430,Wisconsin,Grant County,21581,18450,3131
G4802450,Texas,Jefferson County,104424,101289,3135
G4701850,Tennessee,White County,11511,8369,3142
G5300490,Washington,Pacific County,15547,12404,3143
G5501290,Wisconsin,Washburn County,12979,9829,3150
G2102310,Kentucky,Wayne County,10942,7791,3151
G4500330,South Carolina,Dillon County,13742,10590,3152
G1302810,Georgia,Towns County,7731,4577,3154
G3500090,New Mexico,Curry County,20062,16906,3156
G3801010,North Dakota,Ward County,26744,23585,3159
G4201170,Pennsylvania,Tioga County,21364,18202,3162
G5000190,Vermont,Orleans County,16162,12997,3165
G4201270,Pennsylvania,Wayne County,31653,28480,3173
G4801850,Texas,Grimes County,10917,7744,3173
G2601050,Michigan,Mason County,17293,14119,3174
G4001210,Oklahoma,Pittsburg County,22634,19433,3201
G4800010,Texas,Anderson County,20116,16909,3207
G3600110,New York,Cayuga County,36489,33280,3209
G1302670,Georgia,Tattnall County,9966,6756,3210
G2600590,Michigan,Hillsdale County,21757,18547,3210
G1702030,Illinois,Woodford County,15145,11932,3213
G0101330,Alabama,Winston County,13469,10254,3215
G0500890,Arkansas,Marion County,9354,6139,3215
G2801070,Mississippi,Panola County,14697,11482,3215
G4802170,Texas,Hill County,16118,12899,3219
G2101570,Kentucky,Marshall County,15748,12528,3220
G2601570,Michigan,Tuscola County,24451,21231,3220
G2700050,Minnesota,Becker County,18784,15563,3221
G4200970,Pennsylvania,Northumberland County,45125,41900,3225
G2600330,Michigan,Chippewa County,21253,18023,3230
G4800730,Texas,Cherokee County,20859,17629,3230
G3500290,New Mexico,Luna County,10999,7766,3233
G1200410,Florida,Gilchrist County,7307,4071,3236
G2600270,Michigan,Cass County,25887,22644,3243
G0100450,Alabama,Dale County,22677,19432,3245
G5500570,Wisconsin,Juneau County,14669,11422,3247
G0600510,California,Mono County,13912,10664,3248
G0101110,Alabama,Randolph County,11982,8728,3254
G2200950,Louisiana,St. John the Baptist Parish,17510,14255,3255
G5600290,Wyoming,Park County,13562,10306,3256
G2601510,Michigan,Sanilac County,22725,19465,3260
G4701730,Tennessee,Union County,8958,5696,3262
G5400750,West Virginia,Pocahontas County,8847,5579,3268
G4500370,South Carolina,Edgefield County,10559,7290,3269
G1301430,Georgia,Haralson County,12287,9016,3271
G4700790,Tennessee,Henry County,17054,13774,3280
G2601030,Michigan,Marquette County,34330,31049,3281
G4803610,Texas,Orange County,35313,32032,3281
G4800970,Texas,Cooke County,16606,13315,3291
G5600370,Wyoming,Sweetwater County,18735,15444,3291
G2700970,Minnesota,Morrison County,15731,12434,3297
G3700830,North Carolina,Halifax County,25781,22480,3301
G3500050,New Mexico,Chaves County,26697,23386,3311
G3900510,Ohio,Fulton County,17407,14095,3312
G4600110,South Dakota,Brookings County,13137,9824,3313
G2700170,Minnesota,Carlton County,15656,12342,3314
G3900970,Ohio,Madison County,15939,12621,3318
G1302330,Georgia,Polk County,16908,13585,3323
G2100050,Kentucky,Anderson County,9127,5804,3323
G0500710,Arkansas,Johnson County,11311,7984,3327
G4701030,Tennessee,Lincoln County,15241,11902,3339
G3500170,New Mexico,Grant County,14693,11349,3344
G3600330,New York,Franklin County,25306,21962,3344
G0500630,Arkansas,Independence County,16187,12838,3349
G1301950,Georgia,Madison County,11784,8428,3356
G5600130,Wyoming,Fremont County,17796,14437,3359
G4200990,Pennsylvania,Perry County,20424,17063,3361
G2500110,Massachusetts,Franklin County,33758,30394,3364
G4804070,Texas,San Jacinto County,13187,9823,3364
G1600510,Idaho,Jefferson County,8722,5353,3369
G2700850,Minnesota,McLeod County,15760,12391,3369
G2800030,Mississippi,Alcorn County,17077,13704,3373
G2200690,Louisiana,Natchitoches Parish,18587,15210,3377
G2800670,Mississippi,Jones County,28424,25044,3380
G1800710,Indiana,Jackson County,18202,14820,3382
G1303050,Georgia,Wayne County,12199,8812,3387
G4700570,Tennessee,Grainger County,10894,7501,3393
G2100810,Kentucky,Grant County,9942,6543,3399
G1301830,Georgia,Long County,6039,2638,3401
G1300110,Georgia,Banks County,7595,4193,3402
G4600930,South Dakota,Meade County,11000,7592,3408
G3000530,Montana,Lincoln County,11413,8002,3411
G4000790,Oklahoma,Le Flore County,21448,18029,3419
G1800370,Indiana,Dubois County,17384,13964,3420
G2201170,Louisiana,Washington Parish,21039,17617,3422
G1801450,Indiana,Shelby County,19080,15654,3426
G1300950,Georgia,Dougherty County,40801,37373,3428
G1801830,Indiana,Whitley County,14281,10852,3429
G2800870,Mississippi,Lowndes County,26556,23117,3439
G2801150,Mississippi,Pontotoc County,12440,9001,3439
G2800750,Mississippi,Lauderdale County,34698,31232,3466
G4200630,Pennsylvania,Indiana County,38236,34770,3466
G4500710,South Carolina,Newberry County,17922,14455,3467
G0800150,Colorado,Chaffee County,10020,6547,3473
G2801370,Mississippi,Tate County,10947,7474,3473
G1600110,Idaho,Bingham County,16141,12664,3477
G1800930,Indiana,Lawrence County,21074,17587,3487
G2101450,Kentucky,McCracken County,31079,27581,3498
G4700770,Tennessee,Henderson County,12776,9278,3498
G2701470,Minnesota,Steele County,15343,11840,3503
G4100310,Oregon,Jefferson County,9815,6311,3504
G1302250,Georgia,Peach County,11050,7537,3513
G4802770,Texas,Lamar County,22481,18964,3517
G5500690,Wisconsin,Lincoln County,16784,13256,3528
G5500130,Wisconsin,Burnett County,15278,11743,3535
G2601490,Michigan,St. Joseph County,27778,24242,3536
G3200010,Nevada,Churchill County,10826,7290,3536
G5600230,Wyoming,Lincoln County,8946,5409,3537
G2800490,Mississippi,Hinds County,103421,99860,3561
G1800350,Indiana,Delaware County,52357,48793,3564
G1801510,Indiana,Steuben County,19377,15768,3609
G0600630,California,Plumas County,15566,11942,3624
G4900130,Utah,Duchesne County,9493,5860,3633
G3600210,New York,Columbia County,32775,29139,3636
G4800550,Texas,Caldwell County,13759,10123,3636
G2600190,Michigan,Benzie County,12199,8557,3642
G4700810,Tennessee,Hickman County,10311,6662,3649
G2300230,Maine,Sagadahoc County,18288,14633,3655
G3900750,Ohio,Holmes County,13666,10007,3659
G3901490,Ohio,Shelby County,20173,16509,3664
G4600810,South Dakota,Lawrence County,12756,9092,3664
G4700710,Tennessee,Hardin County,13946,10275,3671
G1300250,Georgia,Brantley County,8086,4404,3682
G2700950,Minnesota,Mille Lacs County,12750,9065,3685
G3600190,New York,Clinton County,35888,32190,3698
G3701070,North Carolina,Lenoir County,27437,23739,3698
G3900910,Ohio,Logan County,23181,19473,3708
G1200030,Florida,Baker County,9687,5975,3712
G1801330,Indiana,Putnam County,14706,10981,3725
G4804590,Texas,Upshur County,16613,12887,3726
G1600390,Idaho,Elmore County,12162,8430,3732
G0101090,Alabama,Pike County,15267,11506,3761
G2600890,Michigan,Leelanau County,14935,11171,3764
G0600930,California,Siskiyou County,23910,20141,3769
G4000970,Oklahoma,Mayes County,19239,15470,3769
G5500450,Wisconsin,Green County,15856,12087,3769
G4804770,Texas,Washington County,15514,11717,3797
G4900390,Utah,Sanpete County,10379,6570,3809
G3900770,Ohio,Huron County,25196,21382,3814
G1300350,Georgia,Butts County,9357,5536,3821
G4900470,Utah,Uintah County,11972,8142,3830
G1600810,Idaho,Teton County,5478,1645,3833
G3901170,Ohio,Morrow County,14155,10312,3843
G2601070,Michigan,Mecosta County,21131,17274,3857
G2901090,Missouri,Lawrence County,16649,12788,3861
G3600250,New York,Delaware County,31222,27361,3861
G0400090,Arizona,Graham County,12980,9112,3868
G2900150,Missouri,Benton County,14150,10280,3870
G2601650,Michigan,Wexford County,16736,12862,3874
G2300290,Maine,Washington County,23001,19124,3877
G2200890,Louisiana,St. Charles Parish,19896,16016,3880
G2800930,Mississippi,Marshall County,14881,10984,3897
G4200370,Pennsylvania,Columbia County,29498,25598,3900
G3900990,Ohio,Mahoning County,111833,107915,3918
G4100110,Oregon,Coos County,30593,26668,3925
G5000250,Vermont,Windham County,29735,25796,3939
G2101730,Kentucky,Montgomery County,11699,7759,3940
G0100330,Alabama,Colbert County,25758,21812,3946
G2200010,Louisiana,Acadia Parish,25387,21441,3946
G4700990,Tennessee,Lawrence County,18177,14229,3948
G1800330,Indiana,DeKalb County,17558,13601,3957
G1300710,Georgia,Colquitt County,18311,14350,3961
G1301690,Georgia,Jones County,11688,7722,3966
G5501150,Wisconsin,Shawano County,20720,16737,3983
G2600170,Michigan,Bay County,48220,44234,3986
G1301330,Georgia,Greene County,8688,4699,3989
G3900050,Ohio,Ashland County,22141,18139,4002
G0801130,Colorado,San Miguel County,6638,2635,4003
G4701430,Tennessee,Rhea County,14365,10361,4004
G4701770,Tennessee,Warren County,17821,13802,4019
G3100790,Nebraska,Hall County,23549,19528,4021
G4803730,Texas,Polk County,22683,18662,4021
G3600510,New York,Livingston County,27123,23084,4039
G4800150,Texas,Austin County,12926,8885,4041
G0800830,Colorado,Montezuma County,12094,8050,4044
G2601370,Michigan,Otsego County,14731,10669,4062
G2200510,Louisiana,Jefferson Parish,189135,185072,4063
G2102150,Kentucky,Spencer County,6704,2640,4064
G1301470,Georgia,Hart County,13007,8942,4065
G2901690,Missouri,Pulaski County,17904,13838,4066
G2100490,Kentucky,Clark County,15706,11635,4071
G5600010,Wyoming,Albany County,17939,13844,4095
G2600350,Michigan,Clare County,23233,19135,4098
G3600310,New York,Essex County,25603,21493,4110
G4201190,Pennsylvania,Union County,16997,12886,4111
G0800510,Colorado,Gunnison County,11412,7294,4118
G1600570,Idaho,Latah County,15988,11870,4118
G2600290,Michigan,Charlevoix County,17249,13119,4130
G4100130,Oregon,Crook County,10202,6066,4136
G4700250,Tennessee,Claiborne County,14859,10711,4148
G4804850,Texas,Wichita County,55566,51413,4153
G3701490,North Carolina,Polk County,11432,7273,4159
G4100070,Oregon,Clatsop County,21546,17367,4179
G1800730,Indiana,Jasper County,13168,8984,4184
G2500030,Massachusetts,Berkshire County,68508,64324,4184
G3600030,New York,Allegany County,26140,21951,4189
G2200610,Louisiana,Lincoln Parish,19479,15286,4193
G2600310,Michigan,Cheboygan County,18298,14090,4208
G3600390,New York,Greene County,29210,25000,4210
G4701170,Tennessee,Marshall County,13119,8909,4210
G3000130,Montana,Cascade County,37276,33063,4213
G2901050,Missouri,Laclede County,15778,11564,4214
G2001210,Kansas,Miami County,13190,8971,4219
G4802030,Texas,Harrison County,27704,23481,4223
G4200390,Pennsylvania,Crawford County,44686,40462,4224
G2200450,Louisiana,Iberia Parish,29698,25472,4226
G4500530,South Carolina,Jasper County,10299,6070,4229
G4801430,Texas,Erath County,16987,12758,4229
G3600130,New York,Chautauqua County,66920,62682,4238
G4801350,Texas,Ector County,53027,48789,4238
G1302750,Georgia,Thomas County,20177,15936,4241
G3901390,Ohio,Richland County,54599,50350,4249
G5500050,Wisconsin,Barron County,23614,19363,4251
G4800370,Texas,Bowie County,38493,34234,4259
G5000270,Vermont,Windsor County,34118,29849,4269
G3600090,New York,Cattaraugus County,41111,36839,4272
G1200270,Florida,DeSoto County,14590,10310,4280
G1302070,Georgia,Monroe County,10710,6401,4309
G4400050,Rhode Island,Newport County,41796,37475,4321
G2901670,Missouri,Polk County,13304,8979,4325
G5000110,Vermont,Franklin County,21588,17250,4338
G3701810,North Carolina,Vance County,20082,15743,4339
G4001350,Oklahoma,Sequoyah County,18656,14314,4342
G4200330,Pennsylvania,Clearfield County,38644,34300,4344
G4803750,Texas,Potter County,47271,42927,4344
G2200990,Louisiana,St. Martin Parish,21941,17592,4349
G3600770,New York,Otsego County,30777,26385,4392
G3900270,Ohio,Clinton County,18133,13740,4393
G4804090,Texas,San Patricio County,26521,22126,4395
G2700490,Minnesota,Goodhue County,20337,15936,4401
G2200170,Louisiana,Caddo Parish,112028,107615,4413
G3701970,North Carolina,Yadkin County,17341,12921,4420
G5300710,Washington,Walla Walla County,23451,19029,4422
G3300050,New Hampshire,Cheshire County,34773,30350,4423
G2300070,Maine,Franklin County,21709,17280,4429
G1302410,Georgia,Rabun County,12313,7883,4430
G4000510,Oklahoma,Grady County,22219,17788,4431
G2200790,Louisiana,Rapides Parish,55684,51239,4445
G0500090,Arkansas,Boone County,16827,12380,4447
G4800070,Texas,Aransas County,15355,10889,4466
G2601550,Michigan,Shiawassee County,30319,25833,4486
G0800290,Colorado,Delta County,14572,10082,4490
G4802990,Texas,Llano County,14280,9773,4507
G1701410,Illinois,Ogle County,22561,18052,4509
G4801710,Texas,Gillespie County,12778,8265,4513
G3100190,Nebraska,Buffalo County,19064,14538,4526
G3500470,New Mexico,San Miguel County,15595,11066,4529
G3701390,North Carolina,Pasquotank County,16833,12298,4535
G2701150,Minnesota,Pine County,17276,12738,4538
G3900710,Ohio,Highland County,19380,14842,4538
G2800350,Mississippi,Forrest County,32289,27740,4549
G2200970,Louisiana,St. Landry Parish,35692,31137,4555
G3901230,Ohio,Ottawa County,27909,23340,4569
G2700610,Minnesota,Itasca County,27065,22494,4571
G2601430,Michigan,Roscommon County,24459,19881,4578
G2700570,Minnesota,Hubbard County,14622,10042,4580
G1801130,Indiana,Noble County,20109,15516,4593
G5500930,Wisconsin,Pierce County,16132,11536,4596
G2500190,Massachusetts,Nantucket County,11618,7021,4597
G4001250,Oklahoma,Pottawatomie County,29139,24528,4611
G3600890,New York,St. Lawrence County,52133,47521,4612
G5000230,Vermont,Washington County,29941,25328,4613
G2900090,Missouri,Barry County,17523,12908,4615
G1701330,Illinois,Monroe County,13392,8774,4618
G4000370,Oklahoma,Creek County,29761,25143,4618
G1200510,Florida,Hendry County,14564,9945,4619
G2700090,Minnesota,Benton County,16140,11521,4619
G2100730,Kentucky,Franklin County,23164,18543,4621
G3601150,New York,Washington County,28844,24216,4628
G4803470,Texas,Nacogdoches County,27406,22768,4638
G1200390,Florida,Gadsden County,19506,14859,4647
G3900090,Ohio,Athens County,26385,21737,4648
G0500550,Arkansas,Greene County,17892,13216,4676
G2600090,Michigan,Antrim County,17824,13145,4679
G1200630,Florida,Jackson County,21003,16320,4683
G2900910,Missouri,Howell County,18021,13326,4695
G4000870,Oklahoma,McClain County,13996,9300,4696
G5500830,Wisconsin,Oconto County,23537,18832,4705
G4000130,Oklahoma,Bryan County,19586,14875,4711
G5500330,Wisconsin,Dunn County,17964,13252,4712
G5300750,Washington,Whitman County,19323,14598,4725
G5600250,Wyoming,Natrona County,33807,29082,4725
G5500750,Wisconsin,Marinette County,30379,25650,4729
G2300130,Maine,Knox County,23744,19009,4735
G2400230,Maryland,Garrett County,18854,14119,4735
G1301770,Georgia,Lee County,10276,5537,4739
G4804650,Texas,Val Verde County,18651,13905,4746
G0101230,Alabama,Tallapoosa County,22111,17312,4799
G0800070,Colorado,Archuleta County,8762,3951,4811
G2901610,Missouri,Phelps County,19533,14715,4818
G0500150,Arkansas,Carroll County,13559,8740,4819
G2100350,Kentucky,Calloway County,18065,13242,4823
G4801830,Texas,Gregg County,49514,44689,4825
G1800670,Indiana,Howard County,38679,33820,4859
G1301750,Georgia,Laurens County,21368,16504,4864
G5400270,West Virginia,Hampshire County,13688,8817,4871
G2201130,Louisiana,Vermilion Parish,25235,20361,4874
G2400410,Maryland,Talbot County,19577,14697,4880
G3500310,New Mexico,McKinley County,25813,20933,4880
G3900070,Ohio,Ashtabula County,46099,41214,4885
G3901290,Ohio,Pickaway County,21275,16385,4890
G5501250,Wisconsin,Vilas County,25116,20225,4891
G3500270,New Mexico,Lincoln County,17519,12622,4897
G2601450,Michigan,Saginaw County,86844,81931,4913
G4000830,Oklahoma,Logan County,17195,12277,4918
G0800390,Colorado,Elbert County,8939,3997,4942
G1301910,Georgia,McIntosh County,9220,4276,4944
G5500850,Wisconsin,Oneida County,30125,25173,4952
G0101130,Alabama,Russell County,24595,19633,4962
G3700110,North Carolina,Avery County,13890,8923,4967
G2601230,Michigan,Newaygo County,25075,20105,4970
G4500290,South Carolina,Colleton County,19901,14926,4975
G4700510,Tennessee,Franklin County,18697,13717,4980
G2100090,Kentucky,Barren County,19188,14202,4986
G3700030,North Carolina,Alexander County,16189,11197,4992
G0100710,Alabama,Jackson County,24786,19768,5018
G3900430,Ohio,Erie County,37845,32827,5018
G5500010,Wisconsin,Adams County,17436,12418,5018
G0500230,Arkansas,Cleburne County,15826,10802,5024
G3700170,North Carolina,Bladen County,17718,12685,5033
G4100570,Oregon,Tillamook County,18359,13324,5035
G3901190,Ohio,Muskingum County,38074,33029,5045
G3600750,New York,Oswego County,53598,48548,5050
G5500810,Wisconsin,Monroe County,19204,14135,5069
G4800190,Texas,Bandera County,11561,6485,5076
G0801190,Colorado,Teller County,12643,7565,5078
G1800610,Indiana,Harrison County,16534,11456,5078
G3700130,North Carolina,Beaufort County,24688,19598,5090
G2600670,Michigan,Ionia County,24778,19674,5104
G3600530,New York,Madison County,31757,26641,5116
G4200690,Pennsylvania,Lackawanna County,96832,91707,5125
G1600650,Idaho,Madison County,11280,6133,5147
G1600850,Idaho,Valley County,11789,6640,5149
G4700130,Tennessee,Campbell County,19966,14817,5149
G1701990,Illinois,Williamson County,30359,25183,5176
G4700290,Tennessee,Cocke County,17459,12282,5177
G1901810,Iowa,Warren County,18371,13157,5214
G0600050,California,Amador County,18032,12814,5218
G4800710,Texas,Chambers County,13291,8061,5230
G5300270,Washington,Grays Harbor County,35166,29932,5234
G1200930,Florida,Okeechobee County,18509,13266,5243
G5501410,Wisconsin,Wood County,34088,28839,5249
G2601590,Michigan,Van Buren County,36785,31530,5255
G5501350,Wisconsin,Waupaca County,25396,20141,5255
G2300010,Maine,Androscoggin County,49090,43815,5275
G2800450,Mississippi,Hancock County,21840,16561,5279
G3500390,New Mexico,Rio Arriba County,19638,14357,5281
G3701670,North Carolina,Stanly County,27110,21808,5302
G2700410,Minnesota,Douglas County,19905,14590,5315
G2001610,Kansas,Riley County,28212,22868,5344
G5500710,Wisconsin,Manitowoc County,37189,31843,5346
G2902250,Missouri,Webster County,14417,9067,5350
G4100590,Oregon,Umatilla County,29693,24333,5360
G5300170,Washington,Douglas County,16004,10640,5364
G4500270,South Carolina,Clarendon County,17467,12101,5366
G4700210,Tennessee,Cheatham County,15663,10297,5366
G0100310,Alabama,Coffee County,22330,16951,5379
G4701450,Tennessee,Roane County,25716,20334,5382
G2300270,Maine,Waldo County,21566,16181,5385
G4700010,Tennessee,Anderson County,34717,29323,5394
G0100210,Alabama,Chilton County,19278,13883,5395
G2601170,Michigan,Montcalm County,28221,22817,5404
G1300690,Georgia,Coffee County,17061,11650,5411
G2700270,Minnesota,Clay County,23959,18546,5413
G2600250,Michigan,Calhoun County,61042,55619,5423
G3600930,New York,Schenectady County,68196,62769,5427
G4900030,Utah,Box Elder County,17326,11890,5436
G3701230,North Carolina,Montgomery County,15914,10421,5493
G1201070,Florida,Putnam County,37337,31840,5497
G2901010,Missouri,Johnson County,21528,16010,5518
G2900270,Missouri,Callaway County,18522,13003,5519
G4000210,Oklahoma,Cherokee County,21455,15935,5520
G3700470,North Carolina,Columbus County,26042,20513,5529
G3400110,New Jersey,Cumberland County,55834,50294,5540
G1600130,Idaho,Blaine County,15050,9500,5550
G0800430,Colorado,Fremont County,19242,13683,5559
G3900150,Ohio,Brown County,19301,13720,5581
G1301450,Georgia,Harris County,13397,7814,5583
G2500070,Massachusetts,Dukes County,17188,11604,5584
G3000470,Montana,Lake County,16588,10972,5616
G5300470,Washington,Okanogan County,22245,16629,5616
G1302850,Georgia,Troup County,28046,22426,5620
G2700590,Minnesota,Isanti County,15321,9693,5628
G3901550,Ohio,Trumbull County,96163,90533,5630
G1800290,Indiana,Dearborn County,20171,14532,5639
G0600690,California,San Benito County,17870,12230,5640
G2300250,Maine,Somerset County,30569,24927,5642
G3701450,North Carolina,Person County,18193,12548,5645
G0100550,Alabama,Etowah County,47454,41787,5667
G5500950,Wisconsin,Polk County,24248,18562,5686
G1302370,Georgia,Putnam County,12804,7113,5691
G4804710,Texas,Walker County,24058,18349,5709
G1800950,Indiana,Madison County,59068,53353,5715
G3701110,North Carolina,McDowell County,20808,15091,5717
G4700030,Tennessee,Bedford County,18360,12638,5722
G4701070,Tennessee,McMinn County,23341,17616,5725
G5600390,Wyoming,Teton County,12813,7060,5753
G4804410,Texas,Taylor County,55750,49988,5762
G1302130,Georgia,Murray County,15979,10207,5772
G0400010,Arizona,Apache County,32514,26731,5783
G4804670,Texas,Van Zandt County,22817,17013,5804
G1302190,Georgia,Oconee County,12383,6561,5822
G2700130,Minnesota,Blue Earth County,26202,20358,5844
G2902190,Missouri,Warren County,14685,8841,5844
G3601010,New York,Steuben County,48875,43019,5856
G2700070,Minnesota,Beltrami County,20527,14670,5857
G0400120,Arizona,La Paz County,16049,10182,5867
G3601170,New York,Wayne County,41057,35188,5869
G2901450,Missouri,Newton County,24313,18384,5929
G5500290,Wisconsin,Door County,23966,18037,5929
G2300150,Maine,Lincoln County,23493,17538,5955
G1300090,Georgia,Baldwin County,20159,14200,5959
G4700190,Tennessee,Carter County,27746,21779,5967
G3901410,Ohio,Ross County,32148,26173,5975
G2000150,Kansas,Butler County,26058,20072,5986
G4800130,Texas,Atascosa County,17631,11614,6017
G2100470,Kentucky,Christian County,29459,23429,6030
G2700210,Minnesota,Cass County,24903,18863,6040
G0601090,California,Tuolumne County,31244,25175,6069
G1302550,Georgia,Spalding County,26777,20702,6075
G0800490,Colorado,Grand County,16061,9985,6076
G1300850,Georgia,Dawson County,10425,4321,6104
G3200070,Nevada,Elko County,19566,13461,6105
G4801990,Texas,Hardin County,22597,16486,6111
G4900510,Utah,Wasatch County,10577,4465,6112
G4100090,Oregon,Columbia County,20698,14576,6122
G2600150,Michigan,Barry County,27010,20887,6123
G1700990,Illinois,LaSalle County,49978,43827,6151
G5500170,Wisconsin,Chippewa County,27185,21024,6161
G1800910,Indiana,LaPorte County,48448,42268,6180
G2400350,Maryland,Queen Anne's County,20140,13944,6196
G1900130,Iowa,Black Hawk County,55887,49688,6199
G4800990,Texas,Coryell County,25178,18970,6208
G1201290,Florida,Wakulla County,12804,6587,6217
G3700090,North Carolina,Ashe County,17342,11119,6223
G3901570,Ohio,Tuscarawas County,40206,33982,6224
G4804690,Texas,Victoria County,35417,29162,6255
G3701750,North Carolina,Transylvania County,19163,12893,6270
G1300290,Georgia,Bryan County,11842,5549,6293
G2701110,Minnesota,Otter Tail County,35594,29295,6299
G4500470,South Carolina,Greenwood County,31054,24735,6319
G4803230,Texas,Maverick County,17462,11143,6319
G4804990,Texas,Wood County,20861,14541,6320
G3600790,New York,Putnam County,38224,31898,6326
G3601090,New York,Tompkins County,41674,35338,6336
G2300170,Maine,Oxford County,36055,29689,6366
G4500250,South Carolina,Chesterfield County,21482,15101,6381
G4500210,South Carolina,Cherokee County,23997,17610,6387
G0601150,California,Yuba County,27635,21245,6390
G2100590,Kentucky,Daviess County,41452,35041,6411
G4804510,Texas,Tom Green County,46571,40135,6436
G4700630,Tennessee,Hamblen County,26963,20514,6449
G1901550,Iowa,Pottawattamie County,39330,32831,6499
G4802910,Texas,Liberty County,28759,22243,6516
G1800850,Indiana,Kosciusko County,37038,30516,6522
G0100150,Alabama,Calhoun County,53289,46753,6536
G1200870,Florida,Monroe County,52764,46215,6549
G4700470,Tennessee,Fayette County,15669,9115,6554
G5400790,West Virginia,Putnam County,23438,16884,6554
G5300650,Washington,Stevens County,21156,14601,6555
G2600470,Michigan,Emmet County,21304,14731,6573
G0601030,California,Tehama County,26987,20403,6584
G3900830,Ohio,Knox County,25118,18508,6610
G4001190,Oklahoma,Payne County,33991,27381,6610
G2100370,Kentucky,Campbell County,39523,32910,6613
G2601110,Michigan,Midland County,35960,29343,6617
G4700310,Tennessee,Coffee County,23434,16786,6648
G0600330,California,Lake County,35492,28822,6670
G4802650,Texas,Kerr County,23831,17161,6670
G4700430,Tennessee,Dickson County,20820,14149,6671
G0600450,California,Mendocino County,40323,33649,6674
G4500310,South Carolina,Darlington County,30297,23601,6696
G0800930,Colorado,Park County,13947,7247,6700
G1800430,Indiana,Floyd County,31968,25238,6730
G3700590,North Carolina,Davie County,18238,11496,6742
G1302950,Georgia,Walker County,30100,23347,6753
G5300310,Washington,Jefferson County,17767,11014,6753
G3701690,North Carolina,Stokes County,21924,15160,6764
G4800050,Texas,Angelina County,35589,28796,6793
G4100350,Oregon,Klamath County,32774,25954,6820
G5500210,Wisconsin,Columbia County,26137,19258,6879
G0100190,Alabama,Cherokee County,16267,9379,6888
G1900610,Iowa,Dubuque County,38951,32053,6898
G3205100,Nevada,Carson City,23534,16628,6906
G4200250,Pennsylvania,Carbon County,34299,27380,6919
G2701310,Minnesota,Rice County,24453,17520,6933
G2102110,Kentucky,Shelby County,16606,9617,6989
G3601130,New York,Warren County,38726,31737,6989
G2101790,Kentucky,Nelson County,18075,11078,6997
G4804730,Texas,Waller County,15839,8824,7015
G0500050,Arkansas,Baxter County,22580,15549,7031
G0801070,Colorado,Routt County,16303,9252,7051
G3900630,Ohio,Hancock County,33174,26107,7067
G1301370,Georgia,Habersham County,18146,11076,7070
G3300010,New Hampshire,Belknap County,37386,30306,7080
G2801050,Mississippi,Oktibbeha County,20947,13861,7086
G3700530,North Carolina,Currituck County,14453,7367,7086
G0501150,Arkansas,Pope County,25551,18430,7121
G4803250,Texas,Medina County,17991,10860,7131
G5500970,Wisconsin,Portage County,30054,22910,7144
G4000310,Oklahoma,Comanche County,50739,43589,7150
G3701050,North Carolina,Lee County,24136,16954,7182
G1301870,Georgia,Lumpkin County,12925,5729,7196
G3700390,North Carolina,Cherokee County,17515,10319,7196
G0101210,Alabama,Talladega County,37088,29861,7227
G5500150,Wisconsin,Calumet County,19695,12465,7230
G5300550,Washington,San Juan County,13313,6075,7238
G2200570,Louisiana,Lafourche Parish,38582,31332,7250
G1801090,Indiana,Morgan County,27754,20500,7254
G1801730,Indiana,Warrick County,24203,16926,7277
G1302270,Georgia,Pickens County,13692,6403,7289
G2900310,Missouri,Cape Girardeau County,32616,25315,7301
G4804270,Texas,Starr County,19526,12209,7317
G1700630,Illinois,Grundy County,19996,12652,7344
G3601050,New York,Sullivan County,49186,41814,7372
G2900510,Missouri,Cole County,32324,24939,7385
G2600210,Michigan,Berrien County,76922,69532,7390
G5600050,Wyoming,Campbell County,18955,11538,7417
G1302910,Georgia,Union County,14052,6624,7428
G5400370,West Virginia,Jefferson County,22037,14606,7431
G2001030,Kansas,Leavenworth County,28697,21264,7433
G3600450,New York,Jefferson County,57966,50519,7447
G1201210,Florida,Suwannee County,19164,11699,7465
G1600050,Idaho,Bannock County,33191,25694,7497
G4201030,Pennsylvania,Pike County,38350,30852,7498
G4500590,South Carolina,Laurens County,30709,23201,7508
G3701710,North Carolina,Surry County,33667,26022,7645
G2701370,Minnesota,St. Louis County,103058,95403,7655
G1800050,Indiana,Bartholomew County,33098,25432,7666
G3300030,New Hampshire,Carroll County,39813,32146,7667
G1301150,Georgia,Floyd County,40551,32821,7730
G4802310,Texas,Hunt County,36704,28959,7745
G3500350,New Mexico,Otero County,30992,23177,7815
G1200750,Florida,Levy County,20123,12307,7816
G4802130,Texas,Henderson County,39595,31779,7816
G1701430,Illinois,Peoria County,83034,75211,7823
G3901590,Ohio,Union County,19429,11599,7830
G1301110,Georgia,Fannin County,16207,8363,7844
G0800850,Colorado,Montrose County,18250,10353,7897
G4802590,Texas,Kendall County,14055,6137,7918
G4701230,Tennessee,Monroe County,20787,12803,7984
G4000410,Oklahoma,Delaware County,24818,16808,8010
G3701570,North Carolina,Rockingham County,43696,35657,8039
G3701630,North Carolina,Sampson County,27234,19183,8051
G4800530,Texas,Burnet County,20870,12801,8069
G3701130,North Carolina,Macon County,25245,17174,8071
G4700730,Tennessee,Hawkins County,26870,18779,8091
G0100090,Alabama,Blount County,23887,15790,8097
G3701930,North Carolina,Wilkes County,33065,24960,8105
G2101130,Kentucky,Jessamine County,19331,11209,8122
G2901870,Missouri,St. Francois County,28458,20321,8137
G0100490,Alabama,DeKalb County,31109,22939,8170
G2801090,Mississippi,Pearl River County,23968,15793,8175
G2200730,Louisiana,Ouachita Parish,64481,56300,8181
G1300210,Georgia,Bibb County,69662,61462,8200
G1701790,Illinois,Tazewell County,57516,49315,8201
G3700270,North Carolina,Caldwell County,37659,29454,8205
G4100410,Oregon,Lincoln County,30610,22389,8221
G1800110,Indiana,Boone County,22754,14516,8238
G1700910,Illinois,Kankakee County,45246,37001,8245
G3500550,New Mexico,Taos County,20265,12020,8245
G4804930,Texas,Wilson County,16766,8516,8250
G4400030,Rhode Island,Kent County,73701,65450,8251
G3901090,Ohio,Miami County,44256,35985,8271
G5500270,Wisconsin,Dodge County,37005,28720,8285
G3400410,New Jersey,Warren County,44925,36589,8336
G2600910,Michigan,Lenawee County,43452,35104,8348
G0400230,Arizona,Santa Cruz County,18010,9595,8415
G2600730,Michigan,Isabella County,28381,19950,8431
G4200030,Pennsylvania,Allegheny County,589201,580738,8463
G2201090,Louisiana,Terrebonne Parish,43887,35416,8471
G0900150,Connecticut,Windham County,49073,40599,8474
G3000810,Montana,Ravalli County,19583,11099,8484
G1700070,Illinois,Boone County,19970,11477,8493
G1301290,Georgia,Gordon County,22278,13777,8501
G2101250,Kentucky,Laurel County,25446,16923,8523
G5300410,Washington,Lewis County,34050,25487,8563
G3900550,Ohio,Geauga County,36574,27922,8652
G3701610,North Carolina,Rutherford County,33878,25220,8658
G3700770,North Carolina,Granville County,22827,14164,8663
G0100430,Alabama,Cullman County,37054,28369,8685
G5300370,Washington,Kittitas County,21900,13215,8685
G2901130,Missouri,Lincoln County,21011,12284,8727
G4701050,Tennessee,Loudon County,21725,12995,8730
G3600630,New York,Niagara County,99120,90385,8735
G4700590,Tennessee,Greene County,32025,23270,8755
G3000490,Montana,Lewis and Clark County,30180,21412,8768
G0600090,California,Calaveras County,27925,19153,8772
G3901690,Ohio,Wayne County,45847,37036,8811
G3701950,North Carolina,Wilson County,35511,26662,8849
G4201250,Pennsylvania,Washington County,92977,84113,8864
G3600830,New York,Rensselaer County,71475,62591,8884
G3300090,New Hampshire,Grafton County,51120,42206,8914
G1302450,Georgia,Richmond County,86331,77288,9043
G2902090,Missouri,Stone County,20373,11294,9079
G2101990,Kentucky,Pulaski County,31443,22328,9115
G4701670,Tennessee,Tipton County,23199,14071,9128
G3700450,North Carolina,Cleveland County,43373,34232,9141
G4803290,Texas,Midland County,54351,45181,9170
G4100030,Oregon,Benton County,36245,27024,9221
G2700250,Minnesota,Chisago County,21172,11946,9226
G3600690,New York,Ontario County,48193,38947,9246
G5501110,Wisconsin,Sauk County,29708,20439,9269
G3700230,North Carolina,Burke County,40879,31575,9304
G3300170,New Hampshire,Strafford County,51697,42387,9310
G2300110,Maine,Kennebec County,60972,51648,9324
G4700890,Tennessee,Jefferson County,23499,14170,9329
G3700610,North Carolina,Duplin County,25728,16395,9333
G5500390,Wisconsin,Fond du Lac County,43910,34548,9362
G0100010,Alabama,Autauga County,22135,12732,9403
G0500330,Arkansas,Crawford County,26115,16711,9404
G5500350,Wisconsin,Eau Claire County,42151,32741,9410
G5500550,Wisconsin,Jefferson County,35147,25719,9428
G2101850,Kentucky,Oldham County,20688,11202,9486
G3400190,New Jersey,Hunterdon County,49487,39987,9500
G4801810,Texas,Grayson County,53727,44223,9504
G1600170,Idaho,Bonner County,24669,15152,9517
G2500150,Massachusetts,Hampshire County,62603,53068,9535
G3200050,Nevada,Douglas County,23671,14121,9550
G4804970,Texas,Wise County,23781,14219,9562
G1301230,Georgia,Gilmer County,16564,6986,9578
G0601010,California,Sutter County,33858,24163,9695
G2600370,Michigan,Clinton County,30695,20959,9736
G0400070,Arizona,Gila County,32698,22961,9737
G5500890,Wisconsin,Ozaukee County,36267,26482,9785
G2300090,Maine,Hancock County,40184,30396,9788
G1300470,Georgia,Catoosa County,26606,16762,9844
G2600870,Michigan,Lapeer County,36332,26445,9887
G2800810,Mississippi,Lee County,35872,25971,9901
G1600830,Idaho,Twin Falls County,31072,21158,9914
G1901690,Iowa,Story County,36789,26847,9942
G4900450,Utah,Tooele County,19455,9510,9945
G1301790,Georgia,Liberty County,26731,16776,9955
G5600210,Wyoming,Laramie County,40462,30507,9955
G1303110,Georgia,White County,16062,6082,9980
G4802210,Texas,Hood County,24951,14958,9993
G4500550,South Carolina,Kershaw County,27478,17479,9999
G4200790,Pennsylvania,Luzerne County,148748,138724,10024
G4701130,Tennessee,Madison County,41877,31809,10068
G5501170,Wisconsin,Sheboygan County,50766,40695,10071
G0100950,Alabama,Marshall County,40342,30225,10117
G2102090,Kentucky,Scott County,19303,9173,10130
G5300150,Washington,Cowlitz County,43450,33304,10146
G2001770,Kansas,Shawnee County,79140,68991,10149
G5500630,Wisconsin,La Crosse County,48402,38239,10163
G4500750,South Carolina,Orangeburg County,42504,32340,10164
G3700930,North Carolina,Hoke County,18211,7999,10212
G5300450,Washington,Mason County,32518,22292,10226
G1300390,Georgia,Camden County,21114,10885,10229
G2800710,Mississippi,Lafayette County,22729,12478,10251
G4701470,Tennessee,Robertson County,26086,15823,10263
G2700350,Minnesota,Crow Wing County,40180,29916,10264
G0100770,Alabama,Lauderdale County,43791,33522,10269
G5300090,Washington,Clallam County,35582,25225,10357
G1801630,Indiana,Vanderburgh County,83003,72637,10366
G1301030,Georgia,Effingham County,19884,9492,10392
G5300070,Washington,Chelan County,35465,25048,10417
G0600230,California,Humboldt County,61559,51134,10425
G4001450,Oklahoma,Wagoner County,29694,19262,10432
G0800670,Colorado,La Plata County,25860,15412,10448
G1901630,Iowa,Scott County,71835,61379,10456
G4701410,Tennessee,Putnam County,31882,21417,10465
G3400370,New Jersey,Sussex County,62057,51574,10483
G4200490,Pennsylvania,Erie County,119138,108585,10553
G0600550,California,Napa County,54759,44199,10560
G4100190,Oregon,Douglas County,48915,38298,10617
G4200010,Pennsylvania,Adams County,40820,30141,10679
G5300210,Washington,Franklin County,24423,13664,10759
G0101030,Alabama,Morgan County,51193,40419,10774
G0800450,Colorado,Garfield County,23309,12517,10792
G1200230,Florida,Columbia County,28636,17818,10818
G0501450,Arkansas,White County,32488,21658,10830
G2100930,Kentucky,Hardin County,43261,32375,10886
G4200750,Pennsylvania,Lebanon County,55592,44634,10958
G2900710,Missouri,Franklin County,43419,32451,10968
G3700870,North Carolina,Haywood County,34954,23975,10979
G4500850,South Carolina,Sumter County,46011,35016,10995
G0501310,Arkansas,Sebastian County,54651,43621,11030
G1303130,Georgia,Whitfield County,39899,28832,11067
G2400450,Maryland,Wicomico County,41192,30108,11084
G4100330,Oregon,Josephine County,38001,26912,11089
G2900970,Missouri,Jasper County,50668,39554,11114
G4900210,Utah,Iron County,19667,8499,11168
G4601030,South Dakota,Pennington County,44949,33741,11208
G3900950,Ohio,Lucas County,202630,191388,11242
G3701270,North Carolina,Nash County,42286,31024,11262
G0900130,Connecticut,Tolland County,57963,46677,11286
G3701410,North Carolina,Pender County,26724,15437,11287
G4100530,Oregon,Polk County,30302,18978,11324
G0600410,California,Marin County,111214,99757,11457
G2600750,Michigan,Jackson County,69458,57979,11479
G3600670,New York,Onondaga County,202357,190878,11479
G2600450,Michigan,Eaton County,47050,35517,11533
G2601210,Michigan,Muskegon County,73561,61962,11599
G3901730,Ohio,Wood County,53376,41760,11616
G3700690,North Carolina,Franklin County,26577,14957,11620
G1800590,Indiana,Hancock County,28125,16495,11630
G5400610,West Virginia,Monongalia County,43238,31563,11675
G4500570,South Carolina,Lancaster County,32687,20929,11758
G1302150,Georgia,Muscogee County,82690,70902,11788
G4700110,Tennessee,Bradley County,41395,29562,11833
G4200450,Pennsylvania,Delaware County,222902,211024,11878
G3700990,North Carolina,Jackson County,25948,14052,11896
G3601110,New York,Ulster County,83638,71716,11922
G3700550,North Carolina,Dare County,33492,21567,11925
G3800150,North Dakota,Burleigh County,35754,23803,11951
G1301570,Georgia,Jackson County,23752,11775,11977
G4600830,South Dakota,Lincoln County,17875,5823,12052
G0500310,Arkansas,Craighead County,40515,28434,12081
G3700370,North Carolina,Chatham County,28753,16642,12111
G0100690,Alabama,Houston County,45319,33196,12123
G2500130,Massachusetts,Hampden County,192175,180025,12150
G2800730,Mississippi,Lamar County,24070,11849,12221
G0500850,Arkansas,Lonoke County,27239,15009,12230
G1300310,Georgia,Bulloch County,28794,16541,12253
G5300250,Washington,Grant County,35083,22809,12274
G4700350,Tennessee,Cumberland County,28151,15864,12287
G4100430,Oregon,Linn County,48821,36482,12339
G4400090,Rhode Island,Washington County,62206,49856,12350
G3400390,New Jersey,Union County,199489,187033,12456
G1800190,Indiana,Clark County,47776,35313,12463
G2300190,Maine,Penobscot County,73860,61359,12501
G4500430,South Carolina,Georgetown County,33672,21134,12538
G0500510,Arkansas,Garland County,50548,37966,12582
G0600870,California,Santa Cruz County,104476,91878,12598
G3701890,North Carolina,Watauga County,32137,19538,12599
G3300130,New Hampshire,Merrimack County,63541,50870,12671
G2100290,Kentucky,Bullitt County,29318,16629,12689
G3700490,North Carolina,Craven County,45002,32293,12709
G2600650,Michigan,Ingham County,121281,108542,12739
G0801170,Colorado,Summit County,29842,17091,12751
G3400090,New Jersey,Cape May County,98309,85537,12772
G4500730,South Carolina,Oconee County,38763,25983,12780
G1701630,Illinois,St. Clair County,116249,103432,12817
G2600550,Michigan,Grand Traverse County,41599,28740,12859
G2101170,Kentucky,Kenton County,68975,56086,12889
G4701190,Tennessee,Maury County,35254,22286,12968
G1301270,Georgia,Glynn County,40716,27724,12992
G4800210,Texas,Bastrop County,29316,16301,13015
G0600310,California,Kings County,43867,30843,13024
G1701670,Illinois,Sangamon County,89901,76873,13028
G2600050,Michigan,Allegan County,49426,36395,13031
G4701630,Tennessee,Sullivan County,73760,60623,13137
G0100510,Alabama,Elmore County,32657,19497,13160
G0900070,Connecticut,Middlesex County,74837,61593,13244
G0900050,Connecticut,Litchfield County,87550,74274,13276
G3500610,New Mexico,Valencia County,30085,16781,13304
G1302470,Georgia,Rockdale County,33272,19963,13309
G2400430,Maryland,Washington County,60814,47448,13366
G2400370,Maryland,St. Mary's County,41282,27863,13419
G2400150,Maryland,Cecil County,41103,27656,13447
G3701090,North Carolina,Lincoln County,33641,20189,13452
G3400310,New Jersey,Passaic County,175966,162512,13454
G3701910,North Carolina,Wayne County,52949,39483,13466
G3600010,New York,Albany County,137739,124255,13484
G0100830,Alabama,Limestone County,34977,21455,13522
G5501050,Wisconsin,Rock County,68422,54840,13582
G2101510,Kentucky,Madison County,35043,21456,13587
G3700310,North Carolina,Carteret County,48179,34576,13603
G5000070,Vermont,Chittenden County,65722,52095,13627
G1600190,Idaho,Bonneville County,39731,26049,13682
G4001310,Oklahoma,Rogers County,35160,21455,13705
G3701550,North Carolina,Robeson County,52751,39045,13706
G1700370,Illinois,DeKalb County,41079,27351,13728
G4803810,Texas,Randall County,51587,37807,13780
G3200190,Nevada,Lyon County,22547,8722,13825
G4100710,Oregon,Yamhill County,37110,23194,13916
G3701590,North Carolina,Rowan County,60211,46264,13947
G2400470,Maryland,Worcester County,55749,41800,13949
G3901130,Ohio,Montgomery County,254775,240820,13955
G5500730,Wisconsin,Marathon County,57734,43774,13960
G3400130,New Jersey,Essex County,312954,298710,14244
G3200230,Nevada,Nye County,22350,8073,14277
G2601470,Michigan,St. Clair County,71822,57494,14328
G2200150,Louisiana,Bossier Parish,49351,34994,14357
G5300290,Washington,Island County,40234,25860,14374
G2800590,Mississippi,Jackson County,60067,45542,14525
G1300130,Georgia,Barrow County,26400,11812,14588
G4200550,Pennsylvania,Franklin County,63219,48629,14590
G5501270,Wisconsin,Walworth County,51531,36937,14594
G5300770,Washington,Yakima County,85474,70852,14622
G4201290,Pennsylvania,Westmoreland County,168199,153554,14645
G2601150,Michigan,Monroe County,62971,48312,14659
G0600830,California,Santa Barbara County,152834,138149,14685
G3400070,New Jersey,Camden County,204943,190145,14798
G2400090,Maryland,Calvert County,33780,18974,14806
G2901650,Missouri,Platte County,39223,24362,14861
G2000450,Kansas,Douglas County,46731,31782,14949
G4900050,Utah,Cache County,37024,22053,14971
G1301850,Georgia,Lowndes County,43921,28906,15015
G3500450,New Mexico,San Juan County,49341,34248,15093
G1300590,Georgia,Clarke County,51068,35971,15097
G0101150,Alabama,St. Clair County,35541,20382,15159
G3001110,Montana,Yellowstone County,63943,48781,15162
G3901330,Ohio,Portage County,67472,52299,15173
G5501010,Wisconsin,Racine County,82164,66945,15219
G0600570,California,Nevada County,52590,37352,15238
G1200550,Florida,Highlands County,55386,40114,15272
G4900430,Utah,Summit County,26545,11256,15289
G4500770,South Carolina,Pickens County,51244,35865,15379
G1900490,Iowa,Dallas County,27260,11812,15448
G4500410,South Carolina,Florence County,58666,43209,15457
G5501090,Wisconsin,St. Croix County,33983,18519,15464
G2900290,Missouri,Camden County,41183,25662,15521
G2200190,Louisiana,Calcasieu Parish,82058,66426,15632
G2900370,Missouri,Cass County,40030,24337,15693
G3600870,New York,Rockland County,104057,88264,15793
G3900610,Ohio,Hamilton County,377364,361421,15943
G2902130,Missouri,Taney County,29255,13273,15982
G1701190,Illinois,Madison County,117106,101098,16008
G0800370,Colorado,Eagle County,31312,15226,16086
G2102270,Kentucky,Warren County,47223,31065,16158
G2701230,Minnesota,Ramsey County,217197,201016,16181
G4803090,Texas,McLennan County,95124,78857,16267
G1200890,Florida,Nassau County,35009,18726,16283
G2201050,Louisiana,Tangipahoa Parish,50073,33640,16433
G0900110,Connecticut,New London County,120994,104461,16533
G3701250,North Carolina,Moore County,43940,27358,16582
G3000630,Montana,Missoula County,50106,33466,16640
G0600890,California,Shasta County,77313,60552,16761
G1300450,Georgia,Carroll County,44607,27736,16871
G1801410,Indiana,St. Joseph County,114849,97956,16893
G3701350,North Carolina,Orange County,55597,38683,16914
G2700190,Minnesota,Carver County,34536,17449,17087
G4200270,Pennsylvania,Centre County,63297,46195,17102
G0101010,Alabama,Montgomery County,101641,84525,17116
G1801050,Indiana,Monroe County,59107,41948,17159
G5501390,Wisconsin,Winnebago County,73329,56123,17206
G3900350,Ohio,Cuyahoga County,621763,604538,17225
G4000170,Oklahoma,Canadian County,45810,28560,17250
G2800470,Mississippi,Harrison County,85181,67813,17368
G3701510,North Carolina,Randolph County,61041,43634,17407
G2701410,Minnesota,Sherburne County,32379,14964,17415
G1800390,Indiana,Elkhart County,77767,60182,17585
G4200430,Pennsylvania,Dauphin County,120406,102684,17722
G2800890,Mississippi,Madison County,38558,20761,17797
G0600530,California,Monterey County,139048,121224,17824
G3600290,New York,Erie County,419974,402131,17843
G5300570,Washington,Skagit County,51473,33580,17893
G1302970,Georgia,Walton County,32435,14514,17921
G0400170,Arizona,Navajo County,56938,38967,17971
G3900570,Ohio,Greene County,68241,50238,18003
G3900850,Ohio,Lake County,101202,83194,18008
G5500590,Wisconsin,Kenosha County,69288,51262,18026
G1300150,Georgia,Bartow County,39823,21757,18066
G4803970,Texas,Rockwall County,27939,9816,18123
G2701450,Minnesota,Stearns County,61974,43806,18168
G4802570,Texas,Kaufman County,38322,20097,18225
G1100010,District Of Columbia,District Of Columbia,296719,278489,18230
G3901510,Ohio,Stark County,165215,146910,18305
G0600390,California,Madera County,49140,30831,18309
G1301130,Georgia,Fayette County,40793,22428,18365
G0801010,Colorado,Pueblo County,69526,50872,18654
G3700350,North Carolina,Catawba County,67886,49192,18694
G4700090,Tennessee,Blount County,55266,36532,18734
G1901030,Iowa,Johnson County,55967,37210,18757
G2900430,Missouri,Christian County,31576,12812,18764
G0400030,Arizona,Cochise County,59041,40238,18803
G3700850,North Carolina,Harnett County,46731,27896,18835
G2400130,Maryland,Carroll County,62406,43553,18853
G4701790,Tennessee,Washington County,57254,38378,18876
G2701090,Minnesota,Olmsted County,60495,41603,18892
G1801270,Indiana,Porter County,66179,47240,18939
G4200190,Pennsylvania,Butler County,78167,59061,19106
G1700190,Illinois,Champaign County,87569,68416,19153
G0600810,California,San Mateo County,271031,251782,19249
G3900890,Ohio,Licking County,69291,50032,19259
G4701890,Tennessee,Wilson County,45568,26198,19370
G5400030,West Virginia,Berkeley County,44762,25385,19377
G3700570,North Carolina,Davidson County,72655,53266,19389
G3400210,New Jersey,Mercer County,143169,123666,19503
G0600250,California,Imperial County,56067,36559,19508
G3700710,North Carolina,Gaston County,88686,69133,19553
G2200050,Louisiana,Ascension Parish,40784,21165,19619
G3900450,Ohio,Fairfield County,58687,39014,19673
G4802510,Texas,Johnson County,56719,37029,19690
G0600070,California,Butte County,95835,76115,19720
G3400010,New Jersey,Atlantic County,126647,106877,19770
G3000290,Montana,Flathead County,46963,26979,19984
G0501250,Arkansas,Saline County,44811,24602,20209
G5501310,Wisconsin,Washington County,54695,34382,20313
G0400050,Arizona,Coconino County,63321,42914,20407
G2400170,Maryland,Charles County,54963,34487,20476
G1701130,Illinois,McLean County,69656,49164,20492
G3700890,North Carolina,Henderson County,54710,34131,20579
G4803670,Texas,Parker County,46628,26044,20584
G3701330,North Carolina,Onslow County,68226,47526,20700
G3000310,Montana,Gallatin County,42289,21350,20939
G3600270,New York,Dutchess County,118638,97632,21006
G2600770,Michigan,Kalamazoo County,110007,88955,21052
G5500870,Wisconsin,Outagamie County,73149,51923,21226
G3700010,North Carolina,Alamance County,66576,45312,21264
G2600490,Michigan,Genesee County,192180,170808,21372
G4400070,Rhode Island,Providence County,264835,243224,21611
G4600990,South Dakota,Minnehaha County,71557,49780,21777
G0601130,California,Yolo County,75054,53000,22054
G3600590,New York,Nassau County,468346,446292,22054
G2701710,Minnesota,Wright County,49000,26353,22647
G1302170,Georgia,Newton County,38342,15494,22848
G4200410,Pennsylvania,Cumberland County,99988,77108,22880
G4804230,Texas,Smith County,87309,64369,22940
G1801570,Indiana,Tippecanoe County,71096,48134,22962
G4500030,South Carolina,Aiken County,72249,49266,22983
G4801390,Texas,Ellis County,54365,31314,23051
G0500450,Arkansas,Faulkner County,46612,23397,23215
G1000010,Delaware,Kent County,65338,42106,23232
G4803030,Texas,Lubbock County,115064,91770,23294
G2200630,Louisiana,Livingston Parish,50170,26848,23322
G1800810,Indiana,Johnson County,56649,33289,23360
G0800770,Colorado,Mesa County,62644,39208,23436
G1301530,Georgia,Houston County,58325,34785,23540
G3600910,New York,Saratoga County,98656,75105,23551
G5300050,Washington,Benton County,68618,44877,23741
G1901130,Iowa,Linn County,92251,68357,23894
G1200850,Florida,Martin County,78131,54199,23932
G0501190,Arkansas,Pulaski County,175555,151538,24017
G4500070,South Carolina,Anderson County,84774,60745,24029
G4800910,Texas,Comal County,47108,22987,24121
G2900990,Missouri,Jefferson County,87626,63423,24203
G4200770,Pennsylvania,Lehigh County,142613,118335,24278
G1702010,Illinois,Winnebago County,125965,101666,24299
G4801870,Texas,Guadalupe County,50015,25592,24423
G1200330,Florida,Escambia County,136703,112230,24473
G4500350,South Carolina,Dorchester County,55186,30632,24554
G2801210,Mississippi,Rankin County,56487,31872,24615
G2100150,Kentucky,Boone County,46154,21476,24678
G2900190,Missouri,Boone County,69551,44695,24856
G1300730,Georgia,Columbia County,48626,23745,24881
G3300150,New Hampshire,Rockingham County,126709,101773,24936
G4200950,Pennsylvania,Northampton County,120363,95345,25018
G2500010,Massachusetts,Barnstable County,160281,135192,25089
G1300970,Georgia,Douglas County,51672,26495,25177
G0600470,California,Merced County,83698,58410,25288
G3900250,Ohio,Clermont County,80656,55315,25341
G3800170,North Dakota,Cass County,67938,42407,25531
G4200890,Pennsylvania,Monroe County,80359,54823,25536
G1800890,Indiana,Lake County,208750,183014,25736
G0100810,Alabama,Lee County,62391,36636,25755
G2300310,Maine,York County,105773,79941,25832
G3901030,Ohio,Medina County,69181,43330,25851
G3101530,Nebraska,Sarpy County,61938,35994,25944
G0101250,Alabama,Tuscaloosa County,84872,58740,26132
G4701650,Tennessee,Sumner County,65968,39807,26161
G3600710,New York,Orange County,137025,110814,26211
G2200550,Louisiana,Lafayette Parish,93656,67431,26225
G2500250,Massachusetts,Suffolk County,315522,289276,26246
G1201310,Florida,Walton County,45132,18728,26404
G1700930,Illinois,Kendall County,40321,13747,26574
G4803550,Texas,Nueces County,141033,114326,26707
G0600170,California,El Dorado County,88159,61451,26708
G2701390,Minnesota,Scott County,47124,20302,26822
G0100970,Alabama,Mobile County,178196,151220,26976
G3900930,Ohio,Lorain County,127036,99937,27099
G0600790,California,San Luis Obispo County,117315,90200,27115
G3400150,New Jersey,Gloucester County,109796,82459,27337
G5500790,Wisconsin,Milwaukee County,418053,390715,27338
G0100730,Alabama,Jefferson County,300552,273097,27455
G3400030,New Jersey,Bergen County,352388,324817,27571
G4500150,South Carolina,Berkeley County,73372,45697,27675
G1300510,Georgia,Chatham County,119323,91178,28145
G1200170,Florida,Citrus County,78026,49854,28172
G4900570,Utah,Weber County,86187,57851,28336
G1800630,Indiana,Hendricks County,55454,26962,28492
G4700650,Tennessee,Hamilton County,151107,122588,28519
G3500430,New Mexico,Sandoval County,52287,23667,28620
G2300050,Maine,Cumberland County,138657,109890,28767
G4800410,Texas,Brazos County,77700,48799,28901
G2400250,Maryland,Harford County,95554,66446,29108
G1200610,Florida,Indian River County,76346,47128,29218
G1800030,Indiana,Allen County,152184,122923,29261
G2500050,Massachusetts,Bristol County,230535,201235,29300
G5500090,Wisconsin,Brown County,104371,74740,29631
G1300770,Georgia,Coweta County,50171,20413,29758
G3500490,New Mexico,Santa Fe County,71267,41464,29803
G3700970,North Carolina,Iredell County,69013,39191,29822
G1200910,Florida,Okaloosa County,92407,62569,29838
G4200110,Pennsylvania,Berks County,164827,134482,30345
G3300110,New Hampshire,Hillsborough County,166053,135622,30431
G3400350,New Jersey,Somerset County,123127,92653,30474
G1301390,Georgia,Hall County,68825,38315,30510
G4100290,Oregon,Jackson County,90937,60376,30561
G2200330,Louisiana,East Baton Rouge Parish,187353,156767,30586
G2900470,Missouri,Clay County,93918,63000,30918
G2600930,Michigan,Livingston County,72809,41863,30946
G1600550,Idaho,Kootenai County,63177,31964,31213
G2900950,Missouri,Jackson County,312105,280729,31376
G2500230,Massachusetts,Plymouth County,200161,168555,31606
G4701550,Tennessee,Sevier County,55918,24166,31752
G3701470,North Carolina,Pitt County,74990,43070,31920
G1201130,Florida,Santa Rosa County,64760,32831,31929
G3700250,North Carolina,Cabarrus County,71937,39713,32224
G3500130,New Mexico,Dona Ana County,81492,49148,32344
G3400050,New Jersey,Burlington County,175615,143236,32379
G0900030,Connecticut,Hartford County,374249,341812,32437
G0800130,Colorado,Boulder County,127071,94621,32450
G4500830,South Carolina,Spartanburg County,122628,89927,32701
G1300630,Georgia,Clayton County,104705,71926,32779
G4701250,Tennessee,Montgomery County,70098,37233,32865
G4801670,Texas,Galveston County,132492,99451,33041
G0600950,California,Solano County,152698,119533,33165
G5300350,Washington,Kitsap County,107367,74038,33329
G1200350,Florida,Flagler County,48595,15215,33380
G3701010,North Carolina,Johnston County,67682,34172,33510
G2500210,Massachusetts,Norfolk County,270359,236816,33543
G3901530,Ohio,Summit County,245109,211477,33632
G1200050,Florida,Bay County,99650,65999,33651
G1200010,Florida,Alachua County,112766,79022,33744
G4000270,Oklahoma,Cleveland County,104821,71038,33783
G4100470,Oregon,Marion County,120948,86869,34079
G3601190,New York,Westchester County,370821,336727,34094
G3400270,New Jersey,Morris County,189842,155745,34097
G3101090,Nebraska,Lancaster County,120875,86734,34141
G4802090,Texas,Hays County,59417,25247,34170
G1200530,Florida,Hernando County,84504,50018,34486
G2500090,Massachusetts,Essex County,306754,271977,34777
G5300730,Washington,Whatcom County,90665,55742,34923
G0900090,Connecticut,New Haven County,362004,327079,34925
G3600550,New York,Monroe County,320593,285524,35069
G1200190,Florida,Clay County,75478,40249,35229
G2400210,Maryland,Frederick County,90136,54872,35264
G3700210,North Carolina,Buncombe County,113365,77951,35414
G2601390,Michigan,Ottawa County,102495,66624,35871
G1200150,Florida,Charlotte County,100632,64641,35991
G2901890,Missouri,St. Louis County,438032,401839,36193
G1600270,Idaho,Canyon County,69409,33137,36272
G4804790,Texas,Webb County,73496,37197,36299
G2601610,Michigan,Washtenaw County,147573,111256,36317
G0601070,California,Tulare County,141696,105013,36683
G2400270,Maryland,Howard County,109282,72583,36699
G0900010,Connecticut,Fairfield County,361221,324355,36866
G1302230,Georgia,Paulding County,52130,15237,36893
G3600850,New York,Richmond County,176656,139726,36930
G2800330,Mississippi,DeSoto County,61634,24472,37162
G3700510,North Carolina,Cumberland County,135524,98360,37164
G2100670,Kentucky,Fayette County,135160,97742,37418
G2201030,Louisiana,St. Tammany Parish,95412,57993,37419
G2900770,Missouri,Greene County,125387,87910,37477
G1201190,Florida,Sumter County,53026,15298,37728
G3900170,Ohio,Butler County,148273,110353,37920
G4900530,Utah,Washington County,57734,19523,38211
G4701870,Tennessee,Williamson County,68498,29875,38623
G4100390,Oregon,Lane County,156112,116676,39436
G3400250,New Jersey,Monmouth County,258410,218408,40002
G3901650,Ohio,Warren County,80750,40636,40114
G3700190,North Carolina,Brunswick County,77482,37114,40368
G0501430,Arkansas,Washington County,87808,47349,40459
G4001090,Oklahoma,Oklahoma County,319828,279340,40488
G4001430,Oklahoma,Tulsa County,268426,227834,40592
G3400170,New Jersey,Hudson County,270335,229682,40653
G2701630,Minnesota,Washington County,92374,51648,40726
G3700670,North Carolina,Forsyth County,156872,115715,41157
G2700030,Minnesota,Anoka County,126688,85519,41169
G0400270,Arizona,Yuma County,87850,46541,41309
G2001730,Kansas,Sedgwick County,211593,170159,41434
G5300670,Washington,Thurston County,108182,66464,41718
G0101170,Alabama,Shelby County,80970,39201,41769
G4900110,Utah,Davis County,97570,55777,41793
G3900410,Ohio,Delaware County,66378,24377,42001
G3701790,North Carolina,Union County,72870,30760,42110
G3700630,North Carolina,Durham County,120217,77710,42507
G1200730,Florida,Leon County,124136,81325,42811
G0600970,California,Sonoma County,204572,161062,43510
G4500910,South Carolina,York County,94196,50438,43758
G4800390,Texas,Brazoria County,118336,74504,43832
G4201330,Pennsylvania,York County,178671,134761,43910
G1000030,Delaware,New Castle County,217511,173560,43951
G4100170,Oregon,Deschutes County,80139,35928,44211
G3701290,North Carolina,New Hanover County,101436,57076,44360
G3400230,New Jersey,Middlesex County,294800,250174,44626
G0801230,Colorado,Weld County,96281,51138,45143
G1201030,Florida,Pinellas County,503634,458341,45293
G4200170,Pennsylvania,Bucks County,245956,199934,46022
G0800310,Colorado,Denver County,285797,239636,46161
G1301170,Georgia,Forsyth County,64052,17869,46183
G1901530,Iowa,Polk County,182262,135979,46283
G4500630,South Carolina,Lexington County,113957,67556,46401
G4500190,South Carolina,Charleston County,169984,123550,46434
G4200710,Pennsylvania,Lancaster County,202952,156462,46490
G4500130,South Carolina,Beaufort County,93023,45981,47042
G3100550,Nebraska,Douglas County,219580,172335,47245
G2500270,Massachusetts,Worcester County,326788,279428,47360
G0600990,California,Stanislaus County,179503,132027,47476
G4100050,Oregon,Clackamas County,156945,109003,47942
G0600750,California,San Francisco County,376942,328471,48471
G1300570,Georgia,Cherokee County,82360,33840,48520
G0100890,Alabama,Madison County,146447,97855,48592
G1000050,Delaware,Sussex County,123036,74253,48783
G1201090,Florida,St. Johns County,89830,40712,49118
G4800270,Texas,Bell County,125470,75957,49513
G1701110,Illinois,McHenry County,116040,65985,50055
G5501330,Wisconsin,Waukesha County,160864,110452,50412
G5300630,Washington,Spokane County,201434,150105,51329
G0800590,Colorado,Jefferson County,229967,178611,51356
G4700930,Tennessee,Knox County,194949,143582,51367
G0500070,Arkansas,Benton County,93084,41444,51640
G4500790,South Carolina,Richland County,161725,109564,52161
G4200290,Pennsylvania,Chester County,192462,139597,52865
G0100030,Alabama,Baldwin County,104061,50933,53128
G4800610,Texas,Cameron County,141924,88759,53165
G0601110,California,Ventura County,281695,228478,53217
G2400050,Maryland,Baltimore County,335622,281553,54069
G2600810,Michigan,Kent County,246901,192698,54203
G0800690,Colorado,Larimer County,132722,77811,54911
G4700370,Tennessee,Davidson County,283978,229064,54914
G2101110,Kentucky,Jefferson County,337616,282578,55038
G1301510,Georgia,Henry County,76533,21275,55258
G2400030,Maryland,Anne Arundel County,212562,157194,55368
G0400250,Arizona,Yavapai County,110432,54805,55627
G0800010,Colorado,Adams County,163136,106947,56189
G2700370,Minnesota,Dakota County,159598,102707,56891
G4701490,Tennessee,Rutherford County,102968,45755,57213
G1200810,Florida,Manatee County,172690,115245,57445
G2400330,Maryland,Prince George's County,328182,270090,58092
G3400290,New Jersey,Ocean County,278052,219863,58189
G4200910,Pennsylvania,Montgomery County,325735,265856,59879
G0400150,Arizona,Mohave County,110911,50822,60089
G2901830,Missouri,St. Charles County,141016,79113,61903
G3600610,New York,New York County,847090,785127,61963
G1201110,Florida,St. Lucie County,137029,73843,63186
G1201170,Florida,Seminole County,181307,117845,63462
G1700430,Illinois,DuPage County,356179,292537,63642
G4500450,South Carolina,Greenville County,195462,131645,63817
G1800570,Indiana,Hamilton County,106772,41074,65698
G2700530,Minnesota,Hennepin County,509469,443583,65886
G0600770,California,San Joaquin County,233755,166274,67481
G5500250,Wisconsin,Dane County,216022,147851,68171
G2500170,Massachusetts,Middlesex County,612004,543796,68208
G1800970,Indiana,Marion County,417862,349403,68459
G4100510,Oregon,Multnomah County,324832,255751,69081
G1200690,Florida,Lake County,144996,75707,69289
G1200830,Florida,Marion County,164050,94567,69483
G0800050,Colorado,Arapahoe County,238301,168665,69636
G4701570,Tennessee,Shelby County,398274,327796,70478
G1700890,Illinois,Kane County,182047,111496,70551
G3600050,New York,Bronx County,511896,440955,70941
G3700810,North Carolina,Guilford County,218017,146812,71205
G1201150,Florida,Sarasota County,228413,157055,71358
G3200310,Nevada,Washoe County,184841,112193,72648
G1201270,Florida,Volusia County,254226,180972,73254
G1300890,Georgia,DeKalb County,304968,231520,73448
G5300110,Washington,Clark County,167413,92849,74564
G0600610,California,Placer County,152648,77879,74769
G4900490,Utah,Utah County,148350,72820,75530
G1700970,Illinois,Lake County,260310,183283,77027
G0600010,California,Alameda County,582549,504109,78440
G1600010,Idaho,Ada County,159471,80849,78622
G1201010,Florida,Pasco County,228928,148965,79963
G0600190,California,Fresno County,315531,235563,79968
G2400310,Maryland,Montgomery County,375905,295723,80182
G1200970,Florida,Osceola County,128170,47959,80211
G2600990,Michigan,Macomb County,356626,274843,81783
G2000910,Kansas,Johnson County,226571,144155,82416
G3600810,New York,Queens County,835127,752690,82437
G4801410,Texas,El Paso County,270307,187473,82834
G3500010,New Mexico,Bernalillo County,284234,201235,82999
G0600130,California,Contra Costa County,400263,316170,84093
G0800350,Colorado,Douglas County,106859,22291,84568
G1200090,Florida,Brevard County,269864,185150,84714
G0600290,California,Kern County,284367,198636,85731
G4100670,Oregon,Washington County,212450,124716,87734
G0800410,Colorado,El Paso County,252852,165056,87796
G3601030,New York,Suffolk County,569985,481317,88668
G0600850,California,Santa Clara County,631920,540240,91680
G2601250,Michigan,Oakland County,527255,432684,94571
G1201050,Florida,Polk County,281214,186225,94989
G4500510,South Carolina,Horry County,185992,89960,96032
G5300530,Washington,Pierce County,325375,228842,96533
G1300670,Georgia,Cobb County,286490,189872,96618
G5300610,Washington,Snohomish County,286659,183942,102717
G1200210,Florida,Collier County,197298,94165,103133
G4803390,Texas,Montgomery County,177647,73871,103776
G1200310,Florida,Duval County,388486,284673,103813
G0400210,Arizona,Pinal County,159222,52732,106490
G4900350,Utah,Salt Lake County,364031,257339,106692
G4804910,Texas,Williamson County,162773,54466,108307
G1701970,Illinois,Will County,237501,122870,114631
G4801570,Texas,Fort Bend County,197030,77075,119955
G4802150,Texas,Hidalgo County,248287,128241,120046
G3900490,Ohio,Franklin County,527186,405418,121768
G3600470,New York,Kings County,1000293,873671,126622
G0600670,California,Sacramento County,555932,417574,138358
G1301210,Georgia,Fulton County,437105,297503,139602
G0400190,Arizona,Pima County,440909,298207,142702
G4801210,Texas,Denton County,256139,112263,143876
G4801130,Texas,Dallas County,943257,795513,147744
G1301350,Georgia,Gwinnett County,291547,137608,153939
G0600710,California,San Bernardino County,699637,542332,157305
G1700310,Illinois,Cook County,2180359,2021833,158526
G1200570,Florida,Hillsborough County,536092,367740,168352
G0600590,California,Orange County,1048907,875072,173835
G4804530,Texas,Travis County,441240,264173,177067
G1200110,Florida,Broward County,810388,628660,181728
G1200710,Florida,Lee County,371099,189051,182048
G3701190,North Carolina,Mecklenburg County,398510,216416,182094
G3701830,North Carolina,Wake County,371836,177146,194690
G4800850,Texas,Collin County,300960,103827,197133
G1200990,Florida,Palm Beach County,664594,461665,202929
G5300330,Washington,King County,851261,647343,203918
G1200950,Florida,Orange County,487839,282686,205153
G4800290,Texas,Bexar County,662872,455832,207040
G1200860,Florida,Miami-Dade County,989435,771288,218147
G0600730,California,San Diego County,1164786,946240,218546
G4804390,Texas,Tarrant County,714803,491152,223651
G0600370,California,Los Angeles County,3445076,3163343,281733
G0600650,California,Riverside County,800707,483847,316860
G4802010,Texas,Harris County,1598698,1173808,424890
G3200030,Nevada,Clark County,840343,317188,523155
G0400130,Arizona,Maricopa County,1639279,952041,687238
G0800140,Colorado,Broomfield County,22646,NA,NA
